model predictive control--mpc	sameAs
mpc--differentiable policy class	isA
differentiable policy class--reinforcement learning	Used-for
model-free--model-based	Conjunction
model-free--approaches	isA
model-based--approaches	isA
state--action	Conjunction
our method--traditional system identiﬁcation	Compare
our mpc policies--neural network	Compare
pendulum--cartpole domains	Conjunction
quantum graphical models--qgms	sameAs
hilbert space embeddings--hses	sameAs
quantum graphical models--graphical models	isA
graphical models--quantum graphical models	isA
qgms--graphical models	Compare
hilbert spaces--spaces	isA
qgm--hses	Compare
qgms--uncertainty	Used-for
sum rule--bayes rule	Conjunction
kernel sum rule--hses	Part-of
bayes rule--qgms	Part-of
sum rule--qgms	Part-of
sum rule--nadaraya-watson kernel regression	isA
bayes rule--nadaraya-watson kernel regression	isA
kernel sum rule--nadaraya-watson kernel regression	isA
hilbert space embedding of hidden quantum markov models--hse-hqmm	sameAs
hse-hqmm--model dynamics	Used-for
hse-hqmms--state-of-the-art models	Compare
lstms--state-of-the-art models	isA
psrnns--state-of-the-art models	isA
convolutional neural networks--neural networks	isA
convolutional neural networks--cnn	sameAs
spherical cnn--cnn	isA
cnn operations--cnn	Part-of
convolution--cnn operations	isA
pooling--cnn operations	isA
graph cnn--cnn	isA
classiﬁcation accuracy--accuracy	sameAs
convolutional neural network--neural network	isA
spherical convolutional neural network--convolutional neural network	isA
deep learning--artiﬁcial intelligence	isA
deepsphere--spherical cnn	isA
graphs--data structures	isA
deepsphere--graph cnn	isA
deepsphere--this approach	sameAs
this approach--using spherical harmonics	Compare
cnn--classiﬁers	Compare
deepsphere--baselines	Compare
large-scale object detection--object detection	isA
large-scale object detection benchmarks--benchmarks	isA
hybrid knowledge routed modules--hkrm	sameAs
semantic correlations--correlations	isA
object categories--categories	isA
knowledge module--knowledge module	Conjunction
hkrm--semantic reasoning	Used-for
hkrm--networks	Feature-of
knowledge module--hkrm	Part-of
text recognition--recognition	isA
scene text recognition--text recognition	isA
scene text recognition accuracy--accuracy	isA
deep neural network--neural network	isA
semantic correlation--correlation	isA
visual information--information	isA
language model--model	isA
unigram language model--language model	isA
scene--text	Conjunction
language--vision	Conjunction
post-processing approach--scene text recognition	Used-for
occurrence probabilities--semantic correlation	Conjunction
word frequencies--semantic relatedness	Conjunction
ﬁnancial transactions--transactions	isA
free decentralized transactional network--transactional network	isA
transactional network--network	isA
transaction veriﬁcation--veriﬁcation	isA
peer-based transaction veriﬁcation--transaction veriﬁcation	isA
transaction features--offnetwork information	Conjunction
short-time fourier transform--fourier transform	isA
short-time fourier transform--stft	sameAs
waveform model--model	isA
speech waveform model--waveform model	isA
neural speech waveform model--speech waveform model	isA
lstms--speech waveform model	Part-of
long short-term memories--lstms	sameAs
uni-directional long short-term memories--long short-term memories	isA
spectra--neural speech waveform model	Used-for
amplitude spectra--phase spectra	Conjunction
phase spectra--calculate the proposed loss	Used-for
amplitude--phase spectra	Conjunction
lstms--auto-regressive structure	Conjunction
auto-regressive structure--speech waveform model	Part-of
neural network--neural network models	sameAs
neural editor--edit encoder	Conjunction
natural language--source code edit data	Conjunction
structure--semantics	Conjunction
task--data source	Conjunction
variational inference with α-divergences--variational inference	isA
variational inference--probabilistic machine learning	isA
kullback-leibler--kl	sameAs
bayesian neural networks--neural networks	isA
soft actor-critic--sac	sameAs
bayesian neural networks--deep reinforcement learning	Conjunction
jacobian matrix--matrix	isA
function landscape--stationary points	Conjunction
stationary points--lipschitz constants	Conjunction
robustness to adversarial attacks--lipschitz constants	Conjunction
function landscape--properties of neural networks	isA
stationary points--properties of neural networks	isA
lipschitz constants--properties of neural networks	isA
robustness to adversarial attacks--properties of neural networks	isA
recurjac--recursive algorithm	isA
activation functions--network	Feature-of
our method--previous approaches	Compare
multiple object tracking--mot	sameAs
video analysis--computer vision	isA
mot--video analysis	Part-of
object detection--mot	Part-of
data association--mot	Part-of
deep learning--data association	Used-for
dan--deep afﬁnity network	sameAs
deep afﬁnity network--deep learning	isA
object detection--data association	Conjunction
ﬁrst step--the second	Conjunction
deep learning--object detection	Used-for
appearance--motion	Conjunction
motion--spatial proximity	Conjunction
spatial proximity--grouping	Conjunction
appearance--hand crafted constraints	isA
object appearances--their afﬁnities between different frames	Conjunction
neural architecture search--search	isA
neural architecture search--enas	sameAs
costar block stacking dataset--dataset	isA
neural network models--neural network	sameAs
hypertrees--low cost automatic design of multiple-input neural network models	Used-for
hypertrees--renas	Compare
renas--neural architecture search	isA
costar block stacking dataset--benchmarking	Used-for
rgb images--current gripper pose	Conjunction
current gripper pose--the action to take	Conjunction
rgb images--inputs	isA
current gripper pose--inputs	isA
the action to take--inputs	isA
frames of real data--stacking attempts	Conjunction
stacking attempts--dataset	Part-of
frames of real data--dataset	Part-of
code--dataset instructions	Conjunction
named entity recognition--ner	sameAs
geowebnews--dataset	isA
natural environment research council--nerc	sameAs
toponym resolution--geocoding	sameAs
nlp models--nlp	Used-for
task--data	Conjunction
data--metrics	Conjunction
task--standard evaluation framework	Part-of
data--standard evaluation framework	Part-of
metrics--standard evaluation framework	Part-of
standard evaluation framework--establish state-of-the-art systems	Used-for
metrics--evaluation data	Conjunction
evaluation data--task deﬁnition	Conjunction
task deﬁnition--framework	Part-of
evaluation data--framework	Part-of
metrics--framework	Part-of
micro blog text--suspicious news detection	Used-for
generative adversarial networks--gan	sameAs
critic network--network	isA
generator--generative adversarial networks	Part-of
critic network--generative adversarial networks	Part-of
novel approach--learning robust classiﬁer	Used-for
regular--adversarial	Conjunction
adversarial cycleconsistency constraint--stability of the adversarial mapping	Used-for
our method--networks trained with adversarial training	Compare
nonparametric--computationally efﬁcient	Conjunction
computationally efﬁcient--interpretable	Conjunction
one model--the other	Compare
our new test--state-of-the-art test	Compare
miniaturization--miniaturization  method	sameAs
compact convolution optimization--compact convolution optimization method	sameAs
miniaturized  u-net--u-net	isA
miniaturization--neural network	Part-of
compact convolution optimization--u-net	Used-for
keras--tensorflow	Conjunction
accelerometers--motion sensors	isA
gyroscopes--motion sensors	isA
convolutional auto-encoders--auto-encoders	isA
caes--convolutional auto-encoders	sameAs
caes--anonymization	Used-for
accelerometers--gyroscopes	Conjunction
this information--user identification	Used-for
data transformation mechanism--share data for specific applications (e.g. monitoring their daily activities) without revealing private user information	Used-for
new multi-objective loss function--caes	Used-for
information about the user’s identity--the data distortion	Conjunction
cae--anonymize sensor data	Used-for
utility--privacy	Conjunction
generation of accurate disparity maps--stereo depth estimation	Part-of
generate accurate but slow mappings--fast but inaccurate ones	Conjunction
a novel approach--disparity prediction	Used-for
end-to-end learned approach--prior work	Compare
computation--accuracy	Conjunction
ﬁnal model--the most competitive baseline	Compare
lesion segmentation--segmentation	isA
stroke lesion segmentation--lesion segmentation	isA
mr images--images	isA
segmentation--prediction	Conjunction
heterogeneous appearance--dynamic evolution	Conjunction
dynamic evolution--inter-patient diﬀerences	Conjunction
heterogeneous appearance--lesions	Feature-of
dynamic evolution--lesions	Feature-of
inter-patient diﬀerences--lesions	Feature-of
methods--acute stroke lesion tasks	Used-for
pathophysiology--anatomy	Conjunction
anatomy--acute stroke lesions	Feature-of
pathophysiology--acute stroke lesions	Feature-of
deep learning--acute stroke tasks	Used-for
stroke lesion segmentation--stroke penumbra estimation	Conjunction
stroke penumbra estimation--chronic extent prediction	Conjunction
similar deep learning architectures--proposed architecture	Compare
method--best submitted entries	Compare
method--rest of submitted strategies	Compare
word2vec--space  embedding models  vector	isA
glove--space  embedding models  vector	isA
fasttext--space  embedding models  vector	isA
word2vec--glove	Conjunction
elmo--space  embedding models  vector	isA
glove--fasttext	Conjunction
fasttext--elmo	Conjunction
nlp--natural language processing	sameAs
magnitude--fast, lightweight tool	isA
magnitude--embeddings	Used-for
magnitude--open source python package	isA
magnitude--gensim	Compare
out-of-vocabulary lookups--features	isA
features--magnitude	Feature-of
navigation over long planning horizons--navigation	isA
navigation over long planning horizons from language input--navigation over long planning horizons	isA
modular approach for learning policies--navigation over long planning horizons from language input	Used-for
compositional--semantic	Conjunction
joint hierarchical training--master policy	Part-of
approach--prior work	Compare
blind echo retrieval--retrieval	isA
blind echo retrieval--blind channel identiﬁcation	isA
blind channel identiﬁcation--signal processing	isA
echo locations--weights	Conjunction
it--blind channel identiﬁcation	isA
it--this problem	sameAs
blind estimation--echo information retrieval	Conjunction
blind estimation--existing methods	Part-of
echo information retrieval--existing methods	Part-of
it--conventional methods	Compare
it--the approach	sameAs
generative adversarial networks--gans	sameAs
adversarial pattern--turing test	isA
finite impulse respons--fir	sameAs
image denoising--image edge deblurring	Feature-of
neural nearest neighbors block--n3 block	sameAs
principle of self-similarity--neural network architectures	Feature-of
convolutional neural network--cnn	sameAs
k-nearest neighbors--knn	sameAs
continuous deterministic relaxation--deterministic relaxation	Feature-of
deterministic relaxation--relaxation	Feature-of
correspondence classiﬁcation--classiﬁcation	Feature-of
dictionary learning--sparse coding	isA
dictionary learning--representation learning	Feature-of
sparse coding--representation learning	Feature-of
orthogonal dictionaries--dictionaries	Feature-of
nonsmooth functions--functions	isA
deep networks with nonsmooth activations--deep networks	Feature-of
relu--activations	Feature-of
unstructured data--clinical note	Feature-of
clinical concept extraction--concept extraction	isA
contextual word embedding--word embedding	isA
bidirectional lstm--lstm	isA
our proposed model--baseline models	Compare
automatic extraction--extraction	isA
extraction--extraction of clinical concept	isA
automatic extraction--extraction of clinical concept	isA
structured--actionable	Conjunction
actionable information--information	isA
concept extraction model--clinical concept extraction	Used-for
concept extraction model--automatic annotation	Used-for
automatic--annotation	isA
automatic annotation--clinical problems	Feature-of
tests--clinical notes	Part-of
treatments--tests	Conjunction
clinical problems--treatments	Conjunction
contextual word embedding--automatic annotation of clinical problems	Used-for
contextual word embedding--contextual word embedding model	isA
corpus--contextual word embedding model	Used-for
clinical reports--wikipedia pages	Conjunction
relevant wikipedia pages--wikipedia pages	isA
relevant wikipedia pages--clinical domain	Feature-of
crf--bidirectional lstm-crf	Part-of
extraction of clinical concept--clinical concept extraction	sameAs
contextual word embedding model--clinical concept extraction	Used-for
baseline models--state-of-the-art models	Conjunction
f1-score--our proposed model	Used-for
catboost--gradient boosting library	sameAs
catboost--publicly available implementations of gradient boosting	Compare
publicly available datasets--datasets	Feature-of
gpu implementation of learning algorithm--the library	Part-of
cpu implementation of scoring algorithm--the library	Part-of
the library--other gradient boosting libraries	Compare
gradient boosting--gradient boosting library	Used-for
categorical features--gradient boosting library	Feature-of
gradient boosting--publicly available implementations of gradient boosting	Used-for
gradient boosting library--open-sourced	isA
gradient boosting library--publicly available implementations of gradient boosting	Compare
gpu implementation of learning algorithm--cpu implementation of scoring algorithm	Conjunction
acute stroke lesion segmentation--segmentation	isA
proposed method--proposed architecture	sameAs
treatment decisions--decisions	isA
time-critical treatment decisions--treatment decisions	isA
acute stroke lesion segmentation--time-critical treatment decisions	Used-for
automatic segmentation--segmentation	isA
automatic segmentation--lesions	Used-for
deep learning--acute stroke	Used-for
sampling strategies--brain lesion related	Used-for
sing--lightweight neural audio synthesizer	isA
sing--generating musical notes	Used-for
mean opinion score--mos	sameAs
sing--state-of-the-art autoencoder	Compare
deep learning--audio synthesis	Used-for
midi synthesizers--audio synthesis	Used-for
speech--music	Conjunction
music generation--generation	isA
vocoders--midi synthesizers	Conjunction
midi synthesizers--speech	Used-for
wavenet--samplernn	Conjunction
samplernn--state-of-the-art neural audio synthesizer	isA
autoregressive models--wavenet	Used-for
our model--sing	sameAs
instruments--sing	Used-for
decoder--instruments	Used-for
conditional generative adversarial networks--generative adversarial networks	Feature-of
generative adversarial networks--generate logos	Used-for
generative algorithms--models	isA
models--designing a logo	Used-for
categorical properties--continuous latent space	Conjunction
multi-moda--categorical properties	Conjunction
continuous latent space--logos	Feature-of
wasserstein generative adversarial neural network--generative adversarial neural network	isA
wasserstein generative adversarial neural network--classiﬁer	Used-for
logan--wasserstein generative adversarial neural network	isA
gradient penalty--wasserstein generative adversarial neural network	Feature-of
logan--generate logos	Used-for
colors--generate logos	Used-for
precision--recall	Conjunction
model--logan	isA
recall--model	Used-for
artiﬁcial intelligence--creative process	Used-for
conditional generative adversarial neural net work--logo generation	Used-for
convolutional neural networks--cnns	sameAs
simple, lightweight approach--context exploitation	Used-for
gather--excite	Conjunction
gather--operators	isA
excite--operators	isA
number of added parameters--computational complexity	Conjunction
resnet-50--counterpart	Compare
encoder-decoder cnn--cnn	isA
domain adaptation--da	isA
reconstruction decoder--encoder-decoder segmentation	Part-of
proposed method--extended classiﬁcation da	Compare
github.com--implementation	Part-of
automated segmentation--segmentation	isA
annotated images--encoder-decoder cnn	Used-for
da--annotation	Used-for
groundtruth data--source domain	isA
target domain--annotation	Used-for
volume electron microscopy--electron microscopy	isA
electron microscopy--em	sameAs
volume electron microscopy--imaging	Part-of
additionsubtraction twin-gated recurrent network--twin-gated recurrent network	isA
twin-gated recurrent network--recurrent network	isA
additionsubtraction twin-gated recurrent network--atr	sameAs
additionsubtraction twin-gated recurrent network--neural machine translation	Used-for
gated rnn--rnn	isA
proposed atr--lstm	Compare
proposed atr--gru	Compare
forward self-attention--atr	Used-for
proposed network--interpretable	isA
atr-based--neural machine translation	Used-for
french--language	isA
german--language	isA
english--language	isA
english-french--language pairs	isA
englishgerman--language pairs	isA
neural machine translation--english-french	Feature-of
chinese--language	isA
chinese word segmentation--word segmentation	Feature-of
atr--natural language processing	Used-for
atr--chinese word segmentation	Used-for
atr--chinese-english translation	Used-for
atr--natural language inference	Used-for
englishgerman--neural machine translation	Feature-of
language pairs--neural machine translation	Feature-of
recurrent units--atr	Used-for
twin-gated mechanism--input and forget gates	Used-for
proposed network--proposed atr	sameAs
translation quality--speed	Conjunction
human dynamics--dynamics	isA
short-term--predictions	Feature-of
long-term--predictions	Feature-of
activity labels--training process	Part-of
pose forecasting models--real-world applications	Feature-of
activity-related annotations--annotations	Feature-of
shortand long-term human pose forecasting--human pose forecasting	Feature-of
action-agnostic method--shortand long-term human pose forecasting	Used-for
hierarchical--multi-scale characteristics	Conjunction
multi-scale characteristics--human dynamics	Feature-of
recurrent neural network--modeling	Used-for
modeling--human dynamics	Feature-of
triangular-prism rnn--tp-rnn	sameAs
new recurrent neural network--recurrent neural network	isA
our method--state-of-the-art method	Compare
github.com--codes	Feature-of
predicting--forecasting	Conjunction
forecasting--human dynamics	Used-for
few-shot learning--meta-learning	isA
model agnostic meta learning--meta learning	Feature-of
model agnostic meta learning--maml	sameAs
single image haze removal--haze removal	Feature-of
conditional gan--remove haze	Used-for
rejection sampling--monte-carlo method	Feature-of
segmentation of the left atrium--la	sameAs
pre-operative atrial ﬁbrillation--af	isA
gadoliniumenhanced magnetic resonance images--magnetic resonance images	Feature-of
magnetic resonance images--mri	sameAs
gadoliniumenhanced magnetic resonance images--ge-mri	sameAs
gadoliniumenhanced magnetic resonance images--left atrial segmentation	Feature-of
deep learning--left atrial segmentation	Used-for
convolutional neural network--pre/post ablation classiﬁcation	Used-for
convolutional neural network--atrial segmentation	Used-for
convolutional neural network--multi-task learning	Used-for
code--github.com	Feature-of
natural language processing--nlp	sameAs
sentence embeddings--natural language processing	Used-for
natural language processing--deep learning methods	Conjunction
scholarly articles in pubmed--clinical notes	Conjunction
mimic-iii--clinical database	isA
biosentvec embeddings--two sentence pair similarity tasks	Used-for
two sentence pair similarity tasks--text genres	Feature-of
biosentvec embeddings--other competitive alternatives	Compare
biosentvec--biomedical text mining	Used-for
biosentvec--github.com	Feature-of
deep learning--summarization	Used-for
news--domains	isA
news--personal stories	Conjunction
personal stories--meetings	Conjunction
meetings--medical articles	Conjunction
personal stories--domains	isA
meetings--domains	isA
medical articles--domains	isA
state of the art extractive summarizers--simpler models	Compare
news--datasets	isA
sentence representations--sumarization task	Used-for
sentence representations--external knowledge sources	Conjunction
external knowledge sources--sumarization task	Used-for
backpropagation--attention mechanisms	Feature-of
adaptive, sparse hyperlayer--learning a sparse transformation	Used-for
attention mechanism--visual classiﬁcation	Used-for
method--differentiable sorting	Feature-of
capsule networks--capsnets	sameAs
capsule networks--image classiﬁcation	Used-for
capsnets--convolutional neural networks	Compare
compositional coding--cc	sameAs
routing algorithm--k-means clustering	Feature-of
proposed method--state-of-the-art approach	Compare
named entity disambiguation--ned	sameAs
deep learning--creating a context vector from graphs	Used-for
creating a context vector from graphs--ned	Feature-of
bi-directional long short-term memory--long short-term memory	Feature-of
long short-term memory--lstm	sameAs
bi-directional long short-term memory--bi-lstm	sameAs
bi-directional long short-term memory--baseline models	Compare
graph classiﬁcation--machine learning	Feature-of
kernel methods--graph classiﬁcation	Used-for
sequential modeling--graph classiﬁcation	Used-for
graph embedding--graph classiﬁcation	Used-for
spectral decomposition--graph laplacian	Feature-of
spectral decomposition--graph classiﬁcation	Used-for
this method--state-of-the-art algorithms	Compare
deep convolutional neural networks--convolutional neural network	Feature-of
orthogonality of weights--convolutional neural network	Feature-of
convolutional neural network--cnns	sameAs
orthogonality regularizations--cnns	Feature-of
state space models--ssms	sameAs
complex time series--time series	Feature-of
stochastic gradient mcmc--sgmcmc	sameAs
stochastic gradient mcmc--bayesian inference	Used-for
discrete--continuous	Conjunction
continuous--mixed-type	Conjunction
mixed-type--ssms	Feature-of
sgmcmc--batch mcmc	Compare
reinforcement learning--rl	sameAs
rlgraph--computation graphs	Used-for
static graph--deﬁne-by-run	Conjunction
static graph--computation graphs	Feature-of
deep learning frameworks--distributed backends	Conjunction
resulting implementations--deep learning frameworks	Compare
long-range spatio-temporal dependencies--spatio-temporal dependencies	Feature-of
non-local module--spatio-temporal dependencies	Used-for
spatio-temporal dependencies--images	Feature-of
spatio-temporal dependencies--videos	Feature-of
recognizing ﬁne-grained objects--actions	Feature-of
constituent parsing--sequence labeling	Feature-of
we--sequence-to-sequence	Compare
bilingual contextual word similarity--bcws	sameAs
english-chinese--bilingual contextual word similarity	Feature-of
sentential contexts--similarity scores	Conjunction
english-chinese word pairs--sentential contexts	Conjunction
our annotated datase--other similar datasets	Compare
cross-lingual sense representations--monolingual understanding	Feature-of
cross-lingual sense representations--multilingual understanding	Feature-of
gated hierarchical attention--gha	sameAs
bottomup gated hierarchical attention--gated hierarchical attention	Feature-of
cnn--decoder	Used-for
gha--one level attention	Compare
state-of-theart models--boosting	Used-for
state-of-theart models--reinforcement learning	Used-for
boosting--reinforcement learning	Conjunction
gha--state-of-theart models	Compare
cnn decoder--gha	Compare
pointwise mutual information--pmi	sameAs
bidaf for qa--esim for nli	Conjunction
neural morphological tagging--pos tagging	Feature-of
morphological tags--composite label	isA
crf--neural multiclass	Conjunction
neural architectures--crf	Compare
armenian--named entity recognition	Feature-of
silver--gold	Feature-of
named entity corpus--corpus	Feature-of
named entity corpus--corpus of news sentences	Conjunction
manual annotation--corpus of news sentences	Feature-of
people--organization	Conjunction
organization--location	Conjunction
location--named entities	Feature-of
wikipedia--news	Conjunction
news--blogs	Conjunction
blogs--encyclopedia	Conjunction
kalman gradient descent--gradient descent	isA
optimization algorithm--algorithm	isA
stochastic optimization algorithm--optimization algorithm	isA
kalman ﬁltering--kalman gradient descent	Used-for
stochastic gradient descent--stochastic optimization algorithm	isA
kalman gradient descent--stochastic gradient descent	isA
stochastic gradient descent--gradient descent	isA
sgd--stochastic gradient descent	sameAs
a theoretical analysis--experimental results	Conjunction
neural networks--variational inference	Conjunction
distributed version of our algorithm--large-dimensional optimization	Used-for
cross-lipschitz extreme value for network robustness--clever	sameAs
extreme value theory--evt	sameAs
deep neural networks--neural networks	Feature-of
deep neural networks--dnns	sameAs
gradient masking--defensive technique	Feature-of
backward pass differentiable approximation--bpda	sameAs
resnet--dnns	Feature-of
inception--dnns	Feature-of
joint clustering--density mode ﬁnding	Conjunction
laplacian k-modes--joint clustering	Used-for
bound optimizer--distributed	Used-for
afﬁnity matrix--matrix	isA
simplex constraints--constraints	isA
inner-loop gradient-ascent--gradient-ascent	isA
inner-loop gradient-ascent--mean-shift	Used-for
code--https://github.com/tiago939/target	Part-of
cost function--function	isA
minimize--cost function	Used-for
backpropagation--hebbian learning	Conjunction
backpropagation--learning rule	Part-of
mnist--fashion-mnist	Conjunction
fashion-mnist--cifar-10	Conjunction
heterogeneous data modalities--data modalities	isA
sensory modalities--modalities	isA
multimodal data--extract information	Used-for
noisy--missing	Conjunction
adversarial learning--privileged information	Conjunction
depth--rgb	Conjunction
rgb videos--videos	isA
semi-supervised segmentation--segmentation	isA
adversarial learning--semi-supervised segmentation	Used-for
generator network--gans	Part-of
feature matching--semi-supervised segmentation	Used-for
gan--semi-supervised segmentation	Used-for
iseg-2017--mrbrains 2013	Conjunction
comprehensive analysis--our work	Part-of
feature matching--cent techniques	isA
cent techniques--conventional adversarial training approaches	Compare
proposed method--state-of-art segmentation networks	Compare
proposed method--segmenting brain mri	Used-for
our work--adversarial learning	isA
a novel method--train a segmentation model	Used-for
generative adversarial networks--a novel method	Part-of
distributional correspondence indexing--dci	isA
text classiﬁcation--classiﬁcation	isA
cross-domain--cross-lingual	Conjunction
cross-lingual--text classiﬁcation	isA
pydci--jadci	Compare
multidomainsentiment--mds	isA
mds--cross-domain adaptation	Used-for
webis-cls-10--cross-lingual adaptation	Used-for
pydci--github.com	Part-of
attention mechanism--biafﬁne classiﬁer	Feature-of
our model--model	isA
accuracy--our model	Feature-of
parameter reduction--our model	Feature-of
babyai research platform--grounded language learning	Used-for
train artiﬁcial agents--understand language instructions	Used-for
humans in the loop--babyai research platform	Part-of
deep learning models--inference of reynolds-averaged navier-stokes solutions	Used-for
accuracy--deep learning models	Part-of
unet architecture--architecture	isA
modernized unet architecture--unet architecture	isA
accuracy--neural networks	Part-of
velocity error--error	isA
pseudo relevance feedback--prf	sameAs
information retrieval--ir	sameAs
top-ranked documents--pseudo relevance feedback	Used-for
retrieval models--models	isA
neural retrieval models--retrieval models	isA
neural models--models	isA
ir models--models	isA
neural ir models--ir models	isA
prf approaches--neural architectures	Conjunction
nprf framework--framework	isA
end-to-end neural prf framework--framework	isA
language modeling methods--methods	isA
large-scale data--language modeling methods	Used-for
language modeling methods--learn the sequential patterns of words	Used-for
sememes--minimum semantic units in human languages	sameAs
sememe-driven language model--sdlm	sameAs
robustness--language models	Used-for
interpretability--language models	Used-for
language modeling--headline generation	Conjunction
sdlm--headline generation	Used-for
sdlm--language modeling	Used-for
nlg task--task	isA
wikilarge dataset--dataset	isA
wikilarge dataset--lstm encoderdecoder networks	Used-for
embellishment algorithms--algorithms	isA
computationally generated stories--compiled computer tales	Part-of
nlg systems--systems	isA
lightweight nlg systems--nlg systems	isA
domain-independent embellishment module--translate	Used-for
focal loss function--loss function	isA
a generalized focal loss function--focal loss function	isA
tversky index--a generalized focal loss function	Used-for
medical image segmentation--image segmentation	isA
dice loss--loss function	Compare
lesions--small structures	isA
image pyramid--attention u-net model	Used-for
isic 2018 dataset--dataset	isA
bus 2017 dataset--dataset	isA
r2-unet--recurrent residual convolutional u-net	sameAs
state-of-the-art performance--u-net	Feature-of
attention u-net--u-net	isA
recurrent residual convolutional u-net--u-net	isA
u-net with residual blocks or blocks with dense connections--u-net	isA
laddernet--a chain of multiple u-nets	isA
a laddernet--u-net	Compare
encoder-decoder branches--a laddernet	Part-of
skip connections--a laddernet	Part-of
fcn--fully convolutional networks	sameAs
segmentation accuracy--accuracy	isA
semantic segmentation--retinal disease detection	Used-for
laddernet--methods in the literature	Compare
a novel machine learning strategy--studying neuroanatomical shape variation	Used-for
studying neuroanatomical shape variation--shape variation	isA
volumetric binary segmentation images--our model	Used-for
extraction of surface points--a mesh	Conjunction
a state-of-the-art benchmark--the proposed representation	Compare
brain structures extracted from mri scans--a shape retrieval task	Used-for
intra-subject variances--learned representation	Feature-of
inter-subject differences--learned representation	Feature-of
pectrogram-based deep learning--deep learning	isA
magnitude spectrogram--input	isA
input--source separation	Used-for
end-to-end models--music source separation	Used-for
waveformbased models--pectrogram-based deep learning	Compare
novel wavenet-based model--wave-u-net	Conjunction
novel wavenet-based model--deepconvsep	Compare
wave-u-net--deepconvsep	Compare
deepconvsep--spectrogram-based deep learning model	isA
end-to-end learning--music source separation	Used-for
computational cost--cost	isA
convolutional networks--networks	isA
deep convolutional networks--convolutional networks	Used-for
high computational cost--deep convolutional networks	Feature-of
unimportant ﬁlters--deep convolutional networks	Part-of
layer-by-layer--pruning	Feature-of
pruning--deep convolutional networks	Used-for
ﬁnetuning--pruning	Part-of
partial least squares--a novel approach	Part-of
partial least squares--to efﬁciently remove ﬁlters	Used-for
partial least squares--variable importance	Conjunction
variable importance--to efﬁciently remove ﬁlters	Used-for
the network without pruning--the method	Compare
the proposed method--existing methods	Compare
codes--https://github.com/arturjordao/pruningneuralnetworks	Part-of
imagenet--validate the proposed method	Used-for
cifar-10--validate the proposed method	Used-for
food-101--validate the proposed method	Used-for
latent variable models--models	isA
spectral methods of moments--learning the parameters of latent variable models	Used-for
our method--previous tensor decomposition methods	Compare
speed--model quality	Conjunction
speed--our method	Feature-of
model quality--our method	Feature-of
speed--previous tensor decomposition methods	Feature-of
model quality--previous tensor decomposition methods	Feature-of
machine reading comprehension--mrc	sameAs
spanextraction dataset--dataset	isA
chinese machine reading comprehension--machine reading comprehension	isA
20,000 real questions--spanextraction dataset	Part-of
understanding--multi-sentence inference	Conjunction
the questions that need comprehensive understanding and multi-sentence inference throughout the context--a challenge set	Part-of
reading comprehension datasets--datasets	isA
machine reading comprehension research--research	isA
spatiotemporal sequence prediction--deep learning	Part-of
a deep-learning-based predictive coding framework--next-frame(s) video prediction	Used-for
convolutional, long short-term memory (convlstm) modules--a deep-learning-based predictive coding framework	Part-of
a novel reduced-gate convolutional lstm (rgclstm) architecture--convlstm	Compare
a deep-learning-based predictive coding framework--framework	isA
convolutional, long short-term memory (convlstm) modules--modules	isA
spatiotemporal sequence prediction--prediction	isA
next-frame(s) video prediction--prediction	isA
a novel reduced-gate convolutional lstm (rgclstm) architecture--architecture	isA
our reduced-gate model--model	isA
next-frame(s) prediction accuracy--prediction accuracy	isA
our reduced-gate model--the original convolutional lstm	Compare
training time.--time	isA
a smaller parameter budget--our reduced-gate model	Used-for
a predictive coding architecture--architecture	isA
our reduced gate modules--modules	isA
our reduced gate modules--a predictive coding architecture	Part-of
mnist--kitti	Conjunction
kitti--datasets	isA
mnist--datasets	isA
training time--time	Used-for
elapsed training time--training time	Used-for
total number of training parameters--elapsed training time	Conjunction
a 25 percent redution in elapsed training time--our reduced-gate model	Feature-of
a signiﬁcant reduction of training parameters--our reduced-gate model	Feature-of
standard convolutional lstm model--model	isA
our reduced-gate model--standard convolutional lstm model	Compare
small devices--devices	isA
autonomous navigation--tracking	Conjunction
motion prediction--prediction	isA
ﬁltering kinematics--motion prediction	Used-for
hand-designed representations--learned representations	Conjunction
hand-designed representations--motion prediction	Used-for
inverse reinforcement learning--reinforcement learning	isA
inverse reinforcement learning--irl	sameAs
irl--trajectory prediction	Used-for
motion--environment	Conjunction
reward function--function	isA
a two-stage neural network architecture--recover the reward function	Used-for
low-level lidar statistics--feature representations	Used-for
kinematics data--data	isA
learned features--features	isA
the ﬁrst-stage network--feature representations	Used-for
environmental--kinematic	Conjunction
multi-modal distributions--complex behaviors	isA
multi-modal distributions at road intersections--complex behaviors	isA
