(angular) motor commands	Other
(cartesian) visual information	Other
(ungrammatical or lexically ambiguous) sentences	Material
-view generation	Task
-view synthesis	Task
1 distance	Other
2-d images	Material
2d features	Method
2d point correspondences	Other
2d/3d image segmentations	Task
3-d reconstruction	Method
3d animation model	Method
3d geometric structure of outdoor video scenes	Task
3d geometrical configuration	Other
3d line constraints	Other
3d line segments	Other
3d model	Method
3d object categorization	Task
3d points and cameras	Other
3d reconstruction	Task
3d reconstructions	Task
3d scene analysis	Task
3d shape and motion	Other
3d shape model	Method
3d surface fitting	Task
3d viewpoint transformations	Other
3–d reconstruction	Task
3–d shape	Other
3–d stereo reconstruction scheme	Method
abduction  of  temporal relations	Task
abductive inference	Method
abstract moves	Material
abstracts	Material
abstracts  of  research articles	Material
abundant unlabelled data	Material
ac-tionness	Eval
accessing  sub-lexical information	Task
accuracies	Eval
accuracy	Eval
accuracy rate	Eval
accurate and robust localization	Task
ace 2003 corpus	Material
ace corpora	Material
ace events	Other
acgmrf model	Method
acoustic measures	Eval
acoustic model	Method
acoustic modeling	Task
acoustic modelling	Method
acoustic noises	Other
acoustic signals of ensemble music	Other
acoustic vector sensor (avs)	Method
acoustic, n-gram, and parser probabilities	Other
acquiring adjectival subcategorization frames  ( scfs )	Task
acquiring sense-tagged data	Task
acquisition of true three-dimensional affine and euclidean models	Task
acquisition program - lexicall -	Method
action attributes	Other
action classification	Task
action detection and search	Task
action model formalism	Method
action models	Method
action positions	Other
action potentials	Other
action proposal	Other
action proposal approaches	Method
action proposal generation	Task
action proposals	Other
action recognition	Task
action recognition algorithms	Method
action type	Other
action videos	Material
actionness score	Eval
actionness scores	Eval
activation-valence space	Other
active camera relocation	Method
active reconstruction systems	Task
active sensing devices	Other
active shape models	Method
activities	Generic
activity	Other
adaboost	Method
adaptation	Task
adaptation and normalization techniques	Method
adaptation data	Material
adaptive bottom-up approach	Method
adaptive dither voting	Method
adaptive dynamic word formation	Task
adaptive learning procedure	Method
adaptive simulated annealing (asa)	Method
additive noise	Other
additive noises	Other
additive operator splitting (aos) techniques	Method
addressee  of a  dialogue act	Other
addressee identification  in  four-participants face-to-face meetings	Task
adhoc task	Task
adhoc tasks	Task
adjacency graph  's  laplacian	Other
adverbial constructs	Other
aerial images	Material
affine cameras	Method
affine case	Other
affine projection	Method
affine specialization	Other
affine-invariant image patches	Other
affix lists	Material
affix removal	Other
ag-glutinative and morphologically rich languages	Material
age-group specific dictionaries	Method
agenda-based scheduling parser	Method
agglutinating free word order language	Material
agglutinative language	Material
agglutinative languages	Other
aggregate queries	Other
aging dictionaries	Method
aging faces	Other
aging process	Task
aging process pattern	Other
ai problem solving techniques	Method
ai text generation	Task
airborne videos	Material
alaryngeal speech	Material
algebraic constraints	Other
algorithms	Generic
aligned  wordnets	Material
aligned bilingual corpus	Material
alignment	Task
alignment adaptation	Method
alignment adaptation approach	Method
alignment errors  in  multilingually aligned wordnets	Other
alignment quality	Eval
alignment techniques	Method
alignments	Other
alternative	Generic
alternative markers	Other
alternative senses	Other
alternatives	Generic
ambient semi-riemannian space	Other
ambient sound	Other
ambiguities	Other
ambiguity  of  speech understanding	Other
ambiguity packing and stochastic disambiguation techniques	Method
ambiguity representations	Method
ambiguity resolution  of  right-side dependencies	Task
ambiguous word	Other
ambiguous wordform	Other
amorph	Method
amount of blurring	Eval
an fibers (anfs)	Other
analog pressure wave	Other
analog programmable array processor (apap)	Task
analog summation of binary products	Other
analogies	Other
analogies between sentences	Task
analogies between words	Task
analogy	Other
analysis and classification of  discourse connectives	Method
analysis of  ellipsis resolution	Task
analysis of  verb form meanings	Task
analysis of discrete events	Task
analysis of plant growth	Task
analytic expression	Other
analytic expressions	Other
analytical expressions	Other
analytical inverses	Method
analyzer	Generic
analyzing metaphors	Task
anaphora references	Other
anaphora resolution	Task
anaphora resolution  within  sentence boundaries	Task
anaphora resolution system	Method
anaphoric component	Method
anaphoric expressions	Other
anaphoric occurrences of il	Task
and and or patterns	Other
anf-based and on-based auditory features	Other
anim-itable avatar	Other
animated gif description dataset	Material
animated gif description task	Task
animated gif understanding	Task
animated gifs	Material
animation of visual speech	Task
animation schema	Method
anisotropic circular gaussian mrf (acgmrf) model	Method
anisotropic meshing	Method
annotated corpus	Material
annotated cross-domain sketch-photo datasets	Material
annotated data	Material
annotated outdoor videos	Other
annotated training corpus	Material
annotating scheme	Method
annotation elements	Other
annotation methods	Method
annotation outliers	Other
annotation outliers/errors	Other
annotation scheme	Method
annotations from amazon mechanical turk	Material
answer expressions	Other
answer extraction	Task
answer resolution algorithm	Method
answering agents	Method
ant system (as)	Method
ant-q	Method
ant-q algorithms	Method
ant-q family	Method
antecedence recovery	Task
antonymy	Other
aperiodic dynamical system	Method
appearance	Other
appearance and motion cues	Other
appearance and motion features	Other
appearance information	Other
appearance variation	Other
appearances of body parts	Other
application	Generic
application back end	Other
applications	Generic
applied natural language processing	Task
approach of wall building and layering	Method
approaches	Generic
approximate joint matrix triangularization	Task
approximate joint triangularizer	Method
approximate least squares estimate (alse) method	Method
approximate model	Method
approximate phrase mapping algorithm	Method
approximate variational technique	Method
approximation error	Other
approximation of  hpsg	Method
approximation of the  formal analysis	Method
apt-based classifier	Method
arabic	Material
arabic documents	Material
arabic information retrieval	Task
arabic stemmer	Method
arabic-english	Material
arabic-english translation task	Task
arbitrary deformations	Other
arbitrary handwriting	Material
arbitrary position	Other
arbitrary, overlapping  features	Other
arc-gv	Method
architectural modules	Method
architecture	Generic
argumental relations	Other
argumentation system	Method
arguments	Other
arm posture	Other
arm reaching movements	Other
arpa large-vocabulary csr corpora	Material
arpa nov93 csr test	Material
artificial intelligence approaches	Method
artificial neural networks	Method
artificial re-verberant conditions	Other
as-closed	Other
as-open	Other
asa	Method
aspectual information	Other
asr	Task
asr accuracy	Eval
asr errors	Other
asr output	Other
asr system	Method
assertions	Other
assessing feasibility of classification	Task
assessment of  language pairs	Task
assessors	Generic
associative relationship	Other
associative relationships between verb phrases	Other
associative similarity	Other
assumed model	Generic
assumptions	Generic
asymmetric map-uniqueness criterion	Eval
asymmetric tsp	Task
asymmetric, or directional, relations	Other
atis (air travel information system) domain	Task
atis csr task	Task
atn	Method
attentional focus	Other
attentional state	Other
attribute selection criteria	Eval
attribute-based representation	Method
auction domains	Task
audible speech	Material
audio and scanned image data	Material
audio processing field	Other
audio recordings	Material
audiovisual emotion recognition challenge (avec)	Material
auditory brainstem	Other
auditory domain	Material
auditory processing	Task
augmented friedman - warren algorithm	Method
augmented transition network	Method
author names	Other
automated evaluation techniques	Method
automated facial expression recognition	Task
automated interpretation  of  nominal compounds	Task
automated plan generation	Task
automated representation learning	Method
automated segmentation	Task
automated surveillance systems	Task
automatic  evaluation metrics	Eval
automatic abstracting systems	Task
automatic acquisition  of  entailment relations	Task
automatic alignments	Other
automatic and  unsupervised evaluation method	Eval
automatic and  unsupervised word sense induction (wsi)	Task
automatic assessment of  local coherence	Task
automatic candidate generation	Method
automatic construction	Task
automatic detection	Task
automatic estimation  of  word significance	Task
automatic estimation method	Method
automatic evaluation	Task
automatic evaluation  of  machine translation  and  document summarization	Task
automatic evaluation measures	Eval
automatic evaluation of  question-answering nl systems	Task
automatic evaluations	Task
automatic extraction  of  translation equivalents	Task
automatic extraction  of  translation lexicons	Task
automatic image annotation	Task
automatic initial-ization problem	Task
automatic metrics	Eval
automatic movie description	Task
automatic parameter optimization	Method
automatic parse-based evaluation	Method
automatic phonetic transcriptions (apts)	Other
automatic speech recognition	Task
automatic speech recognition (asr) system	Method
automatic speech recognition technology	Method
automatic structuring	Task
automatic summa-rization techniques	Method
automatic summarization	Task
automatic tracking of endocardium	Task
automatic transcription	Material
automatic transcriptions	Material
automatic translation of natural language	Task
automatically acquiring  english topic signatures	Task
automatically detecting asr errors	Task
automatically detecting images	Task
automatically evaluating answers to definition questions	Task
automatically generated training data	Material
automatically identifying  predicate argument structures	Task
automatically inducing a  combinatory categorial grammar (ccg) lexicon	Task
automatically labeling the image contents	Task
automatically training  modules	Method
automaton	Other
autonomous pipeline	Generic
auxiliary module of  automatic segmentation	Method
average number of turns	Eval
average packing utilization	Eval
average precision	Eval
average precision metric	Eval
average retrieval times	Eval
averaging the  statistics  of  independently trained models	Other
avoiding  pre-processing distortion	Task
avs	Method
background clutter	Other
background maintenance	Task
background modeling	Task
background scene	Other
background subtraction algorithms	Method
bag-of-words and segment order-sensitive string comparison methods	Method
bag-of-words methods	Method
bagging and boosting algorithms	Method
balanced workloads	Other
balkanet	Material
bare slice disambiguation	Task
base clas-sifiers	Method
base classifier	Generic
base classifiers	Method
base models	Generic
base parser	Method
base-classifier complexity	Eval
baseline	Generic
baseline global feature-based approach	Method
baseline methods	Generic
baseline seg-mentation algorithms	Method
baseline sentence planners	Method
baseline single-view method	Method
baseline system	Generic
baselines	Generic
basic dcg mechanism	Method
basic mapping	Method
basque	Material
batch stochastic gradients	Other
bayes classification error	Other
bayesian analyses	Method
bayesian classifiers	Method
bayesian framework	Method
bayesian inference	Method
bayesian inference techniques	Method
bayesian learning	Method
bayesian learning algorithm	Method
bayesian machine learning	Task
bayesian network	Method
bayesian networks (bns)	Method
bayesian semi-supervised chinese word segmentation model	Method
bayesian statistics	Method
bayesian test	Method
beam-search decoder	Method
begin/after tagging	Method
belief propagation	Method
belief propagation (bp)	Method
benchmark system	Generic
bethe approximation	Method
bi-directional english-spanish fragment	Other
bia	Method
bibliographic citations	Material
bidirectional grammar generation system	Method
bigram	Method
bigram back-off language models	Method
bikel's parser	Method
bilinear subspaces	Other
bilingual context  of  dependency relation	Other
bilingual corpora	Material
bilingual corpus	Material
bilingual dependency relations	Other
bilingual dictionaries	Material
bilingual dictionary coverage	Other
bilingual material	Material
bilingual or multi-lingual texts	Material
bilingual parallel corpora	Material
bilingual parallel corpus	Material
bilingual resource	Material
binary classi-fier	Method
binary classifiers	Method
binary features	Other
binary or local features	Other
binary relations	Other
binary-binary partial matrix-vector multiplication	Method
bio-inspired model	Method
biological entities	Other
biological signals	Material
biology	Material
biomedical and linguistic ontologies	Other
biomedical text	Material
bisdr	Method
bispectral photo-metric stereo	Method
bispectrum	Method
bispectrum amplitude	Other
bispectrum domain (bisdr)	Method
bispectrum mask	Method
bit rates	Other
bit-vector operations	Method
bit-vector-based cky-style parser	Method
bk algorithm	Method
black-box measure of similarity	Eval
black-box methodology	Eval
blackboard-like architecture	Method
bleu	Eval
bleu score	Eval
bleu scores	Eval
blind estimation of reverberation times	Task
blind separation of natural speech signals.	Task
blind separation of underdetermined instantaneous mixtures of independent signals	Task
blind source separation	Task
blob-token set	Other
blob-tokens	Other
block minimization framework	Method
block reordering	Other
block selection criteria	Eval
block unigram model	Method
blocks	Other
blog posts	Material
blogs	Material
blur	Other
blur and illumination changes	Other
blur detection	Method
blur features	Other
blur information	Other
blur kernel estimation	Task
blurred images	Material
blurred regions	Other
bn	Method
bn model	Method
bn model parameters	Other
bn parameter learning	Method
board	Other
board game of go	Task
boolean conditions	Other
boosted combination of random ferns	Method
boosted shape detection	Method
boosting	Method
boosting algorithm	Method
boosting approach	Method
boosting decision stumps	Method
boosting decision trees	Method
boosting method	Method
boosting methods	Method
bootstrapping approach	Method
bootstrapping procedure	Method
borrowing techniques	Method
botanical anatomy	Material
bottleneck features	Other
bottom-up pattern-matching parser	Method
bound	Generic
boundaries of objects	Other
boundaries of the flow segments	Other
boundary detection	Method
bounds	Other
bp	Method
branch and bound strategies	Method
branch-and-bound object detection	Task
branches	Other
breakdowns in coherence	Other
bregman divergence	Other
broad coverage unification based grammar of spanish	Method
broad semantic classes	Other
broadcast news speech	Material
broadly-tuned (muscular) proprioceptive	Other
build-ing/choosing optimal models	Task
building  polarity-tagged corpus	Task
bulgarian	Material
buzzy or metallic artefacts	Other
byron's (2002) manually tuned system	Method
calibrated camera relative pose estimation	Task
calibrated image sequence	Material
camera geometry correction flow	Other
camera handoff in wide-area surveillance scenarios	Task
camera motions	Other
camera view	Other
camera viewpoint	Other
cameras	Other
canadian hansards	Material
candidate parses	Other
canonical graph2tree transformation	Other
canonical transcription	Other
capitalization	Other
caption generation	Task
care	Method
cas approach	Method
cascade	Generic
cascade of simple classifiers	Method
case-based mt (cbmt)	Task
case-based reasoning	Method
case-frame instantiation	Other
categorial grammar	Method
categorization of objects	Task
categorization task	Task
categorizing unknown words	Task
category cooccurrence restrictions (ccrs)	Other
cauchy green deformation tensor	Method
causal and troponymic entailment	Other
causal graph	Other
causal induction algorithms	Method
ccd sensors	Other
ccg	Other
ccg parsing	Task
ccg principles	Method
ccg supertagging	Method
cclinc (common coalition language system at lincoln laboratory)	Method
cclinc korean-to-english translation system	Method
ccr formalism	Task
ccrs	Other
cd-covers	Material
centering theory	Method
cepstrum-based features	Other
cer	Eval
cf grammars	Method
cfg filter	Method
cfg filtering techniques	Method
change decision	Other
change detection methods	Method
changing background	Other
changing illumination conditions	Other
channel normaliza-tion techniques	Method
character  level	Other
character and word error rate	Eval
character bigrams	Method
character error rate (cer)	Eval
character- and word-segmented data	Material
character-based collocation system	Method
characters-based chinese collocation system	Method
chart	Other
chart-based phrase structure parsing	Task
chart-parsing framework	Method
chat-80	Method
checking and refining planning knowledge	Task
checking process models	Task
child language data exchange system (childes)	Material
chine language	Material
chinese	Material
chinese language	Material
chinese natural language processing	Task
chinese newspapers	Material
chinese punctuation marks	Other
chinese term extraction	Task
chinese text	Material
chinese text corpora	Material
chinese text input	Material
chinese texts	Material
chinese word segmenter	Method
chinese word sense disambiguation model	Method
chinese, arabic, and english non-parallel newspaper corpora	Material
chinese-to-english smt model	Method
chinese-to-english translation task	Task
chordal qcns	Method
chords	Material
chunking	Task
cid/dram analog array prototype	Other
citation data sets	Material
citation matching	Task
citations	Other
class of languages	Other
class problem	Task
class structures	Other
class-dependent interpolation  of  n-grams	Method
class-oriented framework	Method
class-specific object detector	Method
classical decision-theoretic problem of weighted expert voting	Task
classical motion segmentation	Task
classical propositional logic	Other
classification	Task
classification  of   word senses	Task
classification accuracy	Eval
classification features	Other
classification method	Method
classification methods	Method
classification of outdoor scenes	Task
classification progress	Method
classification results	Eval
classification stage	Method
classification task	Task
classification-based knowledge representation	Task
classification-based representation techniques	Method
classified advertisements	Material
classifier	Method
classifier assignment	Task
classifier functions	Other
classifier predicates	Other
classifier selection	Task
classifying high-dimensional sequence data	Task
clauses	Other
clean speech	Material
clinical use of hfo features	Task
closed form solution	Method
closed-form (analytical) solution	Method
closed-form segmentation solution	Method
closed-form solution	Method
cloth	Other
cluster analysis	Method
cluster number estimation	Task
cluster tree	Method
clustering  polysemic verbs	Task
clustering  subcategorization frame (scf)  distributions	Task
clustering and filtering processes	Method
clustering framework	Method
clustering function	Other
clustering methods	Method
clustering of patches	Method
clustering of word co-occurrences	Method
clustering process	Method
clustering quality	Eval
clusters	Other
clusters of point tracks	Other
cluttered backgrounds	Other
cluttered scenes	Other
cmos process	Other
cmu  and the  sri toolkit	Method
cnn embedding	Other
cnn models	Method
cnns	Method
co-occurrence distribution	Other
co-occurrence pattern	Other
co-occurrence patterns	Other
co-occurrence similarities	Other
coarse-grained concepts	Other
coarse-level clustering	Task
coarse-to-fine energy minimization strategy	Method
coarse-to-fine manner	Other
coarser graphs	Other
codebook of region types	Other
coder	Generic
coedition	Task
cognitive architecture	Method
cognitive psychology	Material
cognitive semantics	Other
cognitively well-motivated interfaces	Task
cognito-pragmatic nature	Other
coherence  in  essays	Eval
coherence assessment	Task
coherence model	Method
coherence rules	Other
coherent framework	Generic
coherent surfaces	Other
cohesion constraint	Other
cohesive text	Material
collaborative problem solving	Task
collecting tensorial support	Method
collection	Generic
collins (2000) reranker	Method
collocations	Generic
colon	Other
color	Other
color constancy	Task
combination methods	Method
combinatorial auctions	Method
combinatorial optimization	Task
combinatorial optimization problem	Task
combinatorial sports prediction market	Method
combinatory categorial grammar (ccg) lexicon	Other
comma checker	Method
commands	Other
commercial software	Method
commercial systems	Method
commodity hardware	Other
common answer specification	Method
common ground	Task
common language (us english)	Other
common text processing modules	Method
commonlisp	Method
communicative signals	Material
compact description of a video sequence	Task
compact geometric derivation	Other
compact high-pass filters	Method
compact lexicon	Other
compact physical size	Eval
compacted motion features	Other
comparable, non-parallel corpora	Material
comparator	Method
comparator software	Method
competence levels	Other
compile time	Eval
complementary approach	Generic
complementary information	Other
complementary object information	Other
complex	Method
complex bilinear form	Other
complex concepts	Other
complex image data	Material
complex non-rigid motions	Other
complex programmable spatio-temporal dynamics	Other
complex range	Other
complex tree structures	Other
component	Generic
components	Generic
compositional classes of paraphrases	Task
compositional interpretation	Other
compositional syntax rules	Other
compression	Task
compression ratio	Eval
computation of features	Task
computational analysis of move structures	Task
computational bayes-nash equilibrium analysis	Method
computational complexity	Eval
computational cost	Eval
computational lexicon	Other
computational problems	Other
computational tractability and explanatory adequacy	Eval
computations	Generic
computer aided second language learning	Task
computer go	Other
computer memory	Other
computer monitor	Other
computer program   sprint	Method
computer system	Method
computer text generation system	Method
computer vision	Task
computer vision applications	Task
computer vision problems	Task
computer vision tasks	Task
computer-assisted acquisition and morpho-syntactic description of verb-noun collocations	Task
computer-generated sequences	Material
computing optical flow, shape, motion, lighting, and albedo	Task
computing power per area	Eval
concavity	Other
concept	Other
concept hierarchy constraints	Other
concept representations	Method
concept-based seeds	Other
concept-concept matrix	Other
concept-distance measures	Method
concept-to-speech systems	Method
concepts	Other
conceptual dependency theory	Method
conceptual level	Other
conceptual mappings	Other
conceptual operations	Task
conceptual system	Method
concise,  modular architecture	Method
conditional inde-pendencies	Other
conditional independencies	Other
conditional log-linear model	Method
conditional random field (crf)	Method
conditional random field models	Method
conditioning variables	Other
conditions	Generic
confidence measures	Eval
confidence rating	Other
confidence tests	Method
conjugate prior	Other
conjugate priors	Other
conjunction (and) and disjunction (or) of binary features	Other
conjunctions	Other
conll 2008 shared task	Task
connected-digit recognition	Task
connectionist (neural) network	Method
connectionist component	Method
connectivity	Eval
consistency checking	Method
consistent labeling approaches	Method
constant linear drift	Other
constrained delaunay triangulation (cdt)	Method
constrained optimization scheme	Method
constraint formalisms	Method
constraint map of the scene	Other
constraint programming	Method
constraint propagation	Method
constraint system	Generic
constraint-based parser/generator	Method
constraint-based representation  of time	Other
constraint-based tagger	Method
constraints  on  trees	Other
constraints  on  trees decorated with feature structures	Other
constructing word vectors	Task
construction	Task
construction grammar	Method
construction of  domain-independent lexica	Task
construction of  large-scale knowledge sources	Task
construction of causal graphs	Task
construction-specific approach	Method
constructions	Task
contemporary methods	Generic
content summarization	Task
context features	Other
context free languages	Material
context information	Other
context-dependent phone models (intra and interword)	Method
context-free chart parsing	Method
context-free grammars	Method
context-free languages	Material
context-free parsing	Task
context-free phrase structure rules	Other
context-free phrase-structure grammar	Method
contextual information	Other
contextual reference	Other
contextual similarity	Other
continuous and non-overlapping simplices	Other
continuous density hidden markov models (cdhmm)	Method
continuous density hmm	Method
continuous pen motion	Other
continuous speech recognition (csr) techniques	Method
control structure	Other
control structures	Other
conventional context-free morphological grammar	Method
convergence guarantees	Other
conversation	Material
conversation analysis	Method
conversational  telephone speech	Material
conversational context	Other
conversational context features	Other
conversational cues	Other
conversational speech	Material
conversion accuracy	Eval
conversion accuracy of singer identity	Eval
conversion model	Method
converted singing voice	Other
converted singing voice waveforms	Other
convex constraints	Other
convex formulation	Method
convex optimization problem	Task
convex problem	Task
convolution kernel  over  parse trees	Method
convolution tree kernel	Method
convolution-al neural networks	Method
convolutional neural network (cnn)	Method
convolutional neural networks	Method
convolutional neural networks (cnn)	Method
convolutional neural networks (cnn) architectures	Method
convolutional neural networks (cnns)	Method
cooccurrence patterns	Other
cooccurrence statistics	Other
cooperative model	Method
cooperative responses	Other
coordinate structures	Other
coordinated action of neu-rons	Other
coordinations	Other
copying  of  unmodified subgraphs	Other
core argument frame	Other
core english lexicon	Other
core modules	Generic
core-selecting rules	Other
corel photo cds	Material
corpora	Generic
corpus  of human created extracts	Material
corpus annotation project	Task
corpus of bracketed sentences	Material
corpus of multiple english translations	Material
corpus of sentences	Material
corpus study	Task
corpus-based approach	Method
corpus-based lexicon enlargement  and  collocation description	Task
corpus-based lexicon enlargement  phase	Task
corpus-based method	Method
corpus-based sample	Material
corpus-based supervised word sense disambiguation (wsd) system	Method
correct information presentation	Other
correcting  real-word spelling errors	Task
corrective training	Task
correctness proof	Method
correlation measure	Eval
correlation of  dependency relation paths	Other
correspondence theory	Other
corrupted speech signals	Material
cortical motor command	Other
cost aggregation algorithm	Method
cost zero solution	Method
counterparts	Generic
coupled marginalized denoising auto-encoders framework	Method
covariance	Other
cramér-rao lower bound)	Other
creating natural language text	Task
creating summaries	Task
creation of city models	Task
credibility indicators	Other
crf  model	Method
crfs	Method
criteria	Generic
criterion	Generic
criterion  's capability	Other
criterionsm online essay evaluation service	Task
critical cycle	Other
crl's tipster user interface toolkit (tuit)	Method
cross-age face verification	Task
cross-corpus (and cross-language) experiment	Other
cross-domain learning	Task
cross-domain problem	Task
cross-entropy	Method
cross-validation	Method
cross-view ranking constraints	Other
crossed serial dependencies	Other
crossing liaisons	Other
crowdsourcing	Method
crowdsourcing tools	Method
crude model	Generic
csr	Method
cue phrases	Other
cues	Generic
cuhk03 datasets	Material
current algorithms	Method
cursive handwriting recognition	Task
curve-element tokens	Other
cycle structure	Other
cyclic structures	Other
cycloidal motion parameters	Other
cycloidal pen motion	Task
cyclopean views	Other
czech	Material
czech national corpus	Material
czech talking head system	Task
czech wordnet	Material
czech-english statistical machine translation system	Method
dags	Other
damped oscillator cepstral coefficients (doccs)	Method
darpa resource management corpus	Material
dash	Other
data	Generic
data annotation	Task
data augmentation	Method
data dependent local smoothness	Other
data dimension	Other
data matrix	Other
data mining method	Method
data representation	Method
data representations	Method
data retrieval	Task
data structure	Other
data sufficiency	Other
data-dependent bandwidth	Other
data-driven attributes	Other
data-driven markov chain monte carlo (mcmc) process	Method
data-driven selection	Task
data-driven, deep learning-based approach	Method
database	Generic
database  of  tv shows	Material
database access	Task
database of dynamic textures	Material
database query applications	Task
database query paraphrase	Task
database retrieval	Task
database with ground truth	Material
databases	Material
dataset	Generic
dataset of scenes	Material
dataset of urban aerial imagery	Material
dau	Eval
dau measure	Eval
deaf learners	Other
decision list	Other
decision strategies	Method
decision tree	Method
decision tree architecture	Method
decision tree based approach	Method
decision tree building	Method
decision tree learning	Method
decision tree-based context clustering	Method
decision-making	Task
decision-tree classifier	Method
declarative and imperative utterances	Material
declarative formalism	Method
decoded string hypotheses	Other
decoder	Method
decoding algorithm	Method
decoding framework	Method
decoding strategy	Method
deconverter	Method
deconverters	Method
dedicated  word sense disambiguation (wsd) models	Method
dedicated  wsd models	Method
deep archi-tectures	Method
deep embedding methods	Method
deep generative models	Method
deep learning methods	Method
deep link structures	Other
deep long short-term memory (lstm) subnetwork	Method
deep model	Method
deep models	Method
deep networks	Method
deep neural network (dnn) stacked bottleneck features	Method
deep processing	Task
deep representations	Method
deep triplet-ranking model	Method
deep video representation	Method
defeasibility	Other
defeasible reasoning	Method
defeat rules	Other
definite  noun phrase reiteration	Other
definite clause grammar techniques	Method
definition sentences	Other
degree of  ambiguity	Other
deictic information	Other
deictic reference	Other
delimiters	Other
delineation of scene objects	Other
demonstrative expressions	Other
demonstrative forms and functions	Other
demonstrator	Task
denoising auto-encoders learning	Method
dense depth map	Other
dense reconstruction of both textured and texture-less surfaces	Task
dense sub-pixel camera-projector correspondence	Other
dense-stereo dynamic-programming	Method
densely sampled rays	Other
density estimation	Task
dependency accuracy	Eval
dependency grammars	Method
dependency network representation	Method
dependency parsing	Task
dependency pointers	Method
dependency relations	Other
dependency structures	Other
dependency tree	Other
dependency tree kernels	Method
dependency treelet translation pairs	Other
dependency trees	Other
dependency-based grammar model	Method
depression prediction	Task
depth ordering constraints	Other
derivation	Other
derivation tree	Other
derivational history	Other
derivative filters	Method
derived words	Other
description logics (dls)	Method
descriptions	Generic
design	Generic
design of core-selecting payment rules	Task
desktop pcs	Other
detecting  sentence boundaries	Task
detecting 3d objects	Task
detecting fine-grained subtle changes among a scene	Task
detecting interest points	Task
detecting large-scale significant changes	Task
detecting reflections in image sequences	Task
detection and viewpoint classification tasks	Task
detection error	Eval
detection method	Method
detection of  question-answer pairs	Task
detection of abnormal behaviours	Task
detection of flow instabilities	Task
detection rate	Eval
detection rates	Eval
detection sensitivity	Eval
detection task	Task
determination process	Other
deterministic internal feature of the  words	Other
deterministic parser	Method
deterministic parsers	Method
development	Material
device	Generic
devices	Generic
diagnostic tool	Method
diagram interpretation and reasoning	Task
diagram parse graphs (dpg)	Method
diagram question answering	Task
diagram understanding	Task
dialog	Other
dialog model	Method
dialog schemata	Other
dialog systems	Task
dialogue	Material
dialogue acquisition and tracking algorithm	Method
dialogue corpora	Material
dialogue duration	Other
dialogue interaction	Material
dialogue management	Method
dialogue move	Other
dialogue patterns	Other
dialogue state	Other
dialogue strategies	Method
dialogue systems	Method
dialogue translation system	Task
dictionaries of word forms	Other
dictionary bases	Other
dictionary construction	Task
dictionary learning methods	Method
dictionary learning process	Method
dictionary lookup	Method
dictionary lookup stage	Method
dictionary word sense definitions	Other
dictionary-based acquisition  of  collocation lexicon	Task
dictionary-based word vectors	Other
different-quality references	Other
differential features	Other
differential gaussian mixture model (gmm)	Method
differential spectral feature	Other
diffuse reflection	Other
digital learning	Task
digital signal processor (dsp) implementation	Method
digitalization	Other
dimensional container packing problem	Task
dimensionality reduction and density estimation algorithm	Method
direct  mappings  of one  feature structure  into another	Other
direct approaches	Generic
direct orthographical mapping (dom)	Method
direct projection of the minimum-cost surface	Method
direct waveform modification	Method
direction-giving task	Task
directionality  of  dictionaries	Other
dirichlet-multinomial formulation	Method
dis-criminative co-occurrence patterns	Other
disambiguated morphological analysis	Method
disambiguation algorithms	Method
disambiguation of the  dependency structure	Task
disambiguation process	Task
disambiguation tool	Method
discourse	Other
discourse connectives	Other
discourse constraint	Other
discourse copying algorithm	Method
discourse copying phenomena	Task
discourse elements	Other
discourse level  of  annotation	Task
discourse marker insertion algorithm	Method
discourse markers	Other
discourse model	Method
discourse patterns	Other
discourse phenomena	Other
discourse plans	Other
discourse processing algorithms	Method
discourse relations	Other
discourse representation	Method
discourse representation theory	Method
discourse segment	Other
discourse segmentation	Task
discourse segments	Other
discourse structure	Other
discourse task	Task
discourse understanding accuracy	Eval
discourse understanding process	Task
discourse-level construct	Other
discourse-relevant purposes	Other
discourses	Other
discovering parallel sentences	Task
discrete (categorical) and continuous (attribute) emotional assessments	Task
discrete data	Material
discrete events	Other
discrete global optimization problem	Task
discrete motor control representation	Method
discrete nerve-action potentials	Other
discretized viewpoints	Other
discrim-inative patches	Method
discrimination ability	Other
discrimination of human gesture and motion categories	Task
discriminative and compact attribute-based representation	Method
discriminative appearance and shape	Other
discriminative attributes	Other
discriminative co-occurrence patterns	Other
discriminative features	Other
discriminative log-linear models	Method
discriminative model's posterior	Other
discriminative patches	Method
discriminative subspaces building approach	Method
discriminative training criterion	Eval
discursive usage  of 6  chinese punctuation marks	Task
discussing	Other
disjunctive feature structures	Other
disk	Other
disk space	Other
displacement vector fields (dvf)	Other
display of graphical information	Other
dissimilarity measure	Eval
distance	Other
distance-preserving embedding	Other
distant illumination	Other
distillation queries	Other
distinctive textured patterns	Other
distinctiveness	Eval
distributed algorithm	Method
distributed hidden variables	Other
distributed message-passing infrastructure	Method
distributed neural networks	Method
distribution of speech and nsi	Other
distributional approximation	Task
distributional concept-distance measures	Method
distributional hypothesis	Other
distributional measures of word co-occurrences	Method
distributional word feature vectors	Other
distributional word-distance measures	Method
dithering process	Other
diverse noisy situations	Other
diversified (faceted) summaries	Other
diversity	Other
diversity-aware entity summarization approach	Method
divide-and-conquer procedure	Method
dividing  sentences  in  chunks of words	Task
dls	Method
dna strand	Other
doa estimation algorithm	Method
docc features	Method
doccs	Method
document classification	Task
document knowledge base	Material
document oriented preference sets(dops)	Method
document representation	Method
document retrieval for distillation	Task
document summarization	Task
document-oriented applications	Task
documents	Material
documents with signal content	Other
domain dependence	Other
domain divergence	Other
domain expert	Other
domain experts	Other
domain independent acoustic models	Method
domain independent features	Other
domain independent model	Method
domain independent strategy	Method
domain knowledge	Other
domain lexicon expansion	Task
domain specific problems	Task
domain specific terms	Other
domain targeted preference knowledge	Other
domain-independent capabilities	Generic
domain-independent means of evaluating spoken language systems (sls)	Method
domain-specific (in-domain) word alignment	Task
domain-specific semantic information	Other
domain-specific translation lexicons	Other
domain-specific word alignment	Task
domain-speciic models of actions	Method
dominance distribution of speakers	Other
dominance graphs	Other
dominant approaches	Generic
dominant factors	Generic
dominant motion	Other
dominant motion assumption	Other
dops system	Method
dormant independence	Other
dormant independencies	Other
dp-based solution	Method
dpg-based attention model	Method
dpgs	Method
drop-in replacement	Other
drt	Method
dsp	Other
dual coordinate descent method	Method
dubbed sdtm	Method
duration constraints	Other
duration model	Method
dutch	Material
dutch senseval-2 test data	Material
dutch subordinate clauses	Other
dynamic 3d models	Method
dynamic combiner	Method
dynamic hierarchical phrasal lexicon (dhpl)	Other
dynamic label pruning	Method
dynamic language model combination	Method
dynamic models	Method
dynamic ordinal regression	Task
dynamic programming	Method
dynamic programming (dp)	Method
dynamic programming approach	Method
dynamic range of the sensor	Other
dynamic representation	Method
dynamic scene	Other
dynamic-programming based search algorithm	Method
dynamic-programming, stereo algorithm	Method
dynamical changes of the moving objects	Other
dynamical model	Method
dynamical processes	Method
early copying	Other
ebmt	Method
ebmt system	Method
eca	Method
echo-free speech	Material
edge	Other
edge images	Material
edges	Other
edit distance	Method
edit operation	Other
editor	Method
edol	Other
educational tool	Method
efficiency	Eval
efficient robust estimation algorithm	Method
eigenvector solver	Method
eigenvectors	Other
eioeu	Other
eioeu approximation	Method
eiou	Other
ekf outputs	Other
electrical system voltage level	Other
electrolaryngeal speech	Material
electrolaryngeal speech enhancement	Task
electronic discussions	Task
electronic message stream	Material
electronic newsgroup discussions	Material
elementary structures	Other
ellipsis	Other
em algorithm	Method
em-algorithm	Method
email communication	Material
email conversation	Material
email summarization	Task
emails	Material
embedded computer vision application	Task
embedded computer vision applications	Task
embedded hardware	Other
embedding methods	Method
embodied conversational agent	Task
embodied conversational agents	Method
emission process	Method
emission-only images	Material
emoticons	Other
emotions	Material
emphatic facial displays	Material
empirical mt research	Task
encoding sound	Task
encyclopedias	Material
end-task	Generic
end-to-end approach	Method
end-to-end deep convolutional neu-ral network architecture	Method
endocardium	Other
energy function	Other
energy minimization algorithm	Method
english   corpus data	Material
english and czech newspaper texts	Material
english corpus	Material
english phrases	Material
english stemmer	Method
english understanding system	Method
english wikipedia	Material
english, arabic and spanish lexicons	Other
english-bulgarian	Material
english-chinese	Other
english-chinese bitexts	Material
english-chinese parallel corpora	Material
english-estonian	Material
english-hungarian	Material
english-japanese	Other
english-to-japanese dictionary	Material
english-to-korean dictionary	Material
english/chinese and english/japanese language pairs	Material
enhancing spatial resolution	Task
ensemble	Task
ensemble construction	Task
ensemble learning approach	Method
ensemble methods	Method
ensembles	Generic
entailment acquisition	Task
entirely data-driven model selection procedure	Method
entity summarization	Task
entity-based representation  of  discourse	Method
entity-oriented approach	Method
entity-oriented language definition	Other
entity-oriented parser	Method
entropy	Other
enumeration	Method
environmental physics	Material
epileptic brain tissue and activity	Other
epistemological level	Other
epistemological objects	Other
equivalence in meaning	Eval
equivalent readings	Material
error	Eval
error accumulation	Other
error analysis	Method
error bound	Other
error correction	Task
error correction mechanisms	Method
error correction methodology	Method
error corrector	Method
error detection	Task
error rate	Eval
error reduction	Eval
errors	Other
essay-based discourse elements	Other
estimates	Generic
estimates of both scene illuminants and object color (surface reflectance)	Task
estimates of underlying surface re-flectance	Task
estimating affine camera parameters, illumination , shape, and albedo	Method
estimating cameras	Method
estimating location information	Task
estimating object pose	Task
estimation	Generic
estimation of the motion field	Task
estimation of the tensors	Task
estimation of the underlying diffuse color	Other
estimation problem	Task
estimation stage	Method
estimations	Generic
euclidean distance	Other
euclidean space	Other
europarl corpus	Material
eurowordnet	Material
evaluating  wsd programs	Task
evaluation criterion	Eval
evaluation function	Other
evaluation measure	Eval
evaluation measures	Eval
evaluation method	Generic
evaluation methodologies	Generic
evaluation metrics	Eval
evaluation of  human language learners	Task
evaluation of  sls systems	Task
evaluation of natural language systems	Task
evaluation of object detection cascades	Task
evaluation scheme	Generic
evaluation techniques	Generic
evaluations	Generic
event	Other
event detection	Task
event map	Other
event structure	Other
events	Other
evolution of particles	Other
exact  parsing	Task
exact joint triangularizer	Method
examples	Generic
exchange , growth, and transport processes	Task
excitation source	Other
exclamation mark	Other
exemplar-based framework	Method
exhaustive procedure	Method
exhaustive search	Method
existing methods	Generic
existing works	Generic
exotic,  grammatically correct input	Other
expanded  stop lists	Other
expectation maximization (em) algorithm	Method
expectation-maximization (em) algorithm	Method
expectation-maximization (em) based word-clustering algorithm	Method
expected (grammatical) sentences	Material
expected loss	Other
expected-intersection-over-expected-union (eioeu)	Other
expected-iou (eiou) score	Other
experimental language	Generic
experiments	Generic
expert competence levels	Other
expert games	Material
expert human translation	Other
expert human translations	Other
explanation generation	Task
explanation system	Method
explicit filter construction	Method
explicit occlusion handling	Method
exploratory corpus analysis	Task
exponential time lower-bound	Other
expression and perception of emotion	Other
expressions	Generic
expressions of natural languages	Other
expressive speech	Material
expressive speech communication	Task
extended cf grammars	Method
extended conversational sequences	Material
extended domain of locality (edol)	Other
extended kalman filter (ekf)	Method
extension	Generic
extension  lt (lf)	Method
extensional reference	Task
extensions	Generic
external macro context feature	Other
externally digital architecture	Method
extra large (more than 1m words) vocabulary continuous speech recognition	Task
extracted fields	Generic
extracting  subcategorization cues	Task
extracting subcategorization frames	Task
extraction  of  subcategorization cues	Task
extraction of useful  syntactic and semantic features	Task
extraction system	Method
extraction systems	Method
extraneous edges	Other
extraposition grammars	Method
extreme illumination changes	Other
eye contact	Other
eye gaze	Other
f-measure	Eval
f-measures	Eval
f1	Eval
f1-score	Eval
facade textures	Other
facades	Other
face	Other
face database	Task
face detection	Task
face detection system	Method
face geometry	Other
face image super-resolution	Task
face images	Material
face images of non-frontal views	Task
face metrics	Eval
face modeling	Task
face motion patterns	Other
face recognition	Task
face recognition (singular case	Task
face recognition accuracy	Eval
face recognition applications	Task
face recognition systems	Method
face representation and recognition	Task
facial action unit (au) recognition	Task
facial displays	Material
facile, a eu project for multilingual text classification and ie	Method
fact assertions	Other
factor analysis	Method
factored language models	Method
factorization	Method
factors	Generic
fail-soft recovery heuristics	Method
failed parses	Other
failures of reference	Task
false acceptance	Eval
false positive rate	Eval
false positive rates	Eval
family	Generic
family history domain	Material
faq-like questions and answers	Material
fast  computation  of  lexical affinity models	Task
fast algorithms	Generic
fast detection	Task
fast methods	Generic
fast performance	Eval
faster convergence	Eval
favorable properties	Generic
feasibility study	Task
feature	Other
feature detection errors	Other
feature extraction	Other
feature functions	Other
feature mapping	Method
feature parameter training	Method
feature points	Other
feature selection methods	Method
feature space	Other
feature structure unification	Method
feature structure-directed generation	Method
feature structures	Other
feature vector quality	Eval
feature vectors	Other
feature weighting and selection function	Method
feature-based matching	Task
feature-based methods	Method
feature-based partial descriptions	Other
feature-based word grammar	Method
features of entities	Other
features space	Other
february 1992 atis benchmark tests	Material
feedback	Other
feedback production	Task
ferret	Method
field	Generic
field structured extraction tasks	Task
field structured text	Material
file card model of  discourse model  and  knowledge store	Method
filter interactions	Other
filtering mechanism	Method
financial transfers	Material
fine-grained  annotation	Other
fine-grained change detection	Task
fine-grained change detection of misaligned scenes	Task
fine-grained cross-domain ranking tasks	Task
fine-grained grammatical categories	Other
fine-grained matching	Task
fine-grained modeling of  unknown word features	Method
fine-grained probabilistic estimation of outcomes	Task
fine-grained sketch-based image retrieval (sbir)	Task
fine-grained triplet ranking annotations	Other
finegrained  cfg rules	Other
finer clusters	Other
finest graph	Other
finite state model (fsm)	Method
finite time lyapunov exponent (ftle) field	Other
finite-state	Other
finite-state models	Method
finnish	Material
first	Generic
first pass	Generic
first-order and second-order co-occurrence	Other
first-order autoregressive model	Method
first-order derivatives of the motion field	Other
first-order upper bound	Other
fish twisting	Other
fisher-rao metric	Eval
fixed-length feature vectors	Other
fixes	Other
fkt	Method
flash/non-flash and rgb/nir images	Material
flexibilities	Generic
flexibility	Eval
flexible betting language	Other
flexible parser	Method
flexible parsing	Task
flexp	Method
flic and mpii datasets	Material
flickr30k and mscoco image-sentence datasets	Material
flickr30k entities dataset	Material
flow	Other
flow field	Other
flow map	Method
flowfield representation of the faces	Method
flowing text	Material
fluo-rescence	Other
fluorescence	Other
fluorescence's wavelength-shifting property	Other
fluorescence-based method	Method
fluorescent dyes	Other
fluorescent materials	Other
football announcements	Material
football dataset	Material
forests	Other
form-oriented dictionary description	Method
formal analysis	Method
formal computation  of the  logical form	Other
formal language	Other
formal models	Method
formalism	Generic
formalism of  category cooccurrence restrictions (ccrs)	Task
formalisms	Generic
formalization  of  defeasible reasoning	Method
formatted weather data	Material
former	Generic
forming articulatory trajectories	Task
formulation	Generic
forward chaining rule systems	Task
forward-backward algorithm	Method
fragment-and-compose	Method
fragment-and-compose paradigm	Method
fragmentary input	Other
fragmentary recognition	Task
frame rate	Other
frame semantics paradigm	Method
frame-level component	Method
frame-to-frame alignment	Method
framework	Generic
free word order	Other
free-content encyclopedia	Material
free-form text input	Material
free-hand (finger) sketches	Other
free-hand human sketches	Other
french	Material
french broadcast news transcriptions	Material
french sentence	Material
french tenses	Other
french-dutch	Material
frequency bands	Other
frequency components	Method
frequency counts  of  word n-grams	Method
frequency of occurrences	Other
frequency profiles	Generic
froff	Method
frontal views of human faces	Other
fsm	Method
fujisaki model	Method
fujisaki-model parameters	Other
full digital resolution	Eval
full nps	Other
full parsing	Task
full scale two-level morphological description	Task
full unification	Task
full-length support set	Other
full-length supports	Other
fully automated extraction system	Method
fully automatic recognition system	Method
fully-automatically learned challenge-response system	Method
fully-connected first-order statistical class grammar	Method
function words	Other
functional objects	Other
fundamental frequency (f0) contour of speech	Other
fusion of measurement information with system dynamics and shape priors	Method
g3d dataset	Material
game records of expert players	Material
game tree search	Method
gaussian	Method
gaussian blurring	Other
gaussian distribution	Method
gaussian mixture	Method
gaussian mixture models (gmms)	Method
gaussian models	Method
gaussian scale space	Other
gaze	Other
gb's binding theory	Method
gear scale factors	Other
gears	Other
gender classification task	Task
gender judgment	Other
gene and protein interactions	Task
general  translation lexicons	Other
general and domain corpora	Material
general domains	Material
general linguistic knowledge	Other
general purpose prop-agators	Method
general scenarios	Material
general-purpose nlp components	Method
generalizable semantic principles	Other
generalization of factor analysis	Method
generalized lr parsing	Method
generalized metaphor	Other
generalized metaphor mappings	Method
generalized quantifier approach	Method
generalized translation knowledge	Other
generating  sub-categorization cues	Task
generating responses or confirmations	Task
generation	Task
generation algorithm	Method
generation of synthesized speech	Task
generation system	Method
generative and discriminative components	Method
generative framework	Method
generative history-based latent variable model	Method
generative model	Method
generative phonological approach	Method
generative proba-bilistic framework	Method
generative proba-bilistic model	Method
generative probabilistic model  of  parse trees	Method
generative probabilistic model of natural language	Method
generative probabilistic optical character recognition (ocr) model	Method
generator	Generic
generic action proposals	Other
generic face appearance variation	Task
generic measurement process	Method
generic qualitative constraints	Other
generic summarization	Task
generic temporal constraint	Other
generic, indicative  summaries	Other
genetic algorithm	Generic
genetic search	Method
genre-specific regularities  of  discourse structure	Other
genres	Generic
geo-tags	Other
geodesic distance	Other
geodesically local appearance manifold structure	Other
geometric classes	Other
geometric constraints	Other
geometric context of video	Other
geometric correspondence data	Material
geometric estimation problems	Task
geometric framework	Method
geometric interpretation	Other
geometric model	Method
geometric prior	Other
geometric structure of crowd patterns	Other
geometric structures of 3d lines	Task
geometric transformation space	Other
geometric understanding of conjugate priors	Other
geometric, appearance, or correlation-based information	Other
geometrization of class structures	Method
geometry-oriented model-based recognition approaches	Method
german	Material
german corpus	Material
german derivation	Material
german pronouns	Other
german speech	Material
german text corpora	Material
german-english	Material
gesture	Material
glimpse measure	Eval
glimpse measures	Eval
glimpse proportion	Eval
global alignment	Task
global computability	Other
global consistency constraints	Other
global context	Other
global data structure	Other
global lighting reconstruction	Other
global navigation satellite system (gnss)	Task
global non-sequential traversal	Other
global optima	Other
global optimization problem	Task
global optimum	Other
global parse tree	Other
global properties	Other
global registration	Task
global scale	Other
global variables	Other
glosser	Method
gmm	Method
gnss measurement noise	Other
gnss signal	Other
gnss/ins coupling	Task
go players	Other
gold-standard parse trees	Other
golem	Method
google video	Material
gpsg	Method
gpsg grammatical formalism	Method
gradient	Other
gradient space	Other
grammar	Method
grammar  tailoring	Task
grammar checker	Method
grammar coverage problems	Other
grammar formalisms	Method
grammar sensu stricto	Other
grammars	Method
grammatical and ungrammatical input	Other
grammatical formalisms	Method
grammatical frameworks	Method
grammatical gender	Other
grammatical input	Other
grammatical number	Other
grammatical relations  ( grs )	Other
grammaticality	Eval
granularity	Eval
granularity a priori	Other
graph	Other
graph  of  translation hypotheses	Other
graph cuts	Method
graph structure	Other
graph structure of the video	Other
graph transformations	Task
graph unification	Task
graph-based technique	Method
graph-cuts optimization	Method
graphic interpretation system	Method
graphic's caption	Material
graphical display	Other
graphical information	Other
graphical model	Method
graphical models	Method
graphical relationship	Other
graphical user interface (gui) functions	Other
graphics displays	Other
graphics for vision  approach	Method
graphs	Other
grass-mannian manifolds	Method
gravity vector	Other
gray-level band-pass white noise patterns	Other
greedy optimization algorithm	Method
greedy search	Method
greedy techniques	Method
grid of particles	Other
grolier's encyclopedia	Material
grosz-sidner-style focus model	Method
ground truth figure-ground segmentations	Method
grounding	Task
grouping of data	Task
grs	Other
guidance image	Material
guis	Other
h-corf parameters	Other
haggisgac	Method
halliday's systemic networks	Method
hand contours	Material
hand prepared datasets	Material
hand-built, symbolic resources	Material
hand-crafted rules	Other
hand-crafted system	Method
hand-crafted template-based generation component	Method
hand-crafted template-based or rule-based approaches	Method
hand-crafting  knowledge-based generation systems	Method
hand-designed objective functions	Method
hand-produced sets	Other
handcrafted features	Other
handcrafted rules	Other
handwritten capital letter classification (nonsingular case)	Task
hard budget constraints	Other
hard combinatorial problem	Task
hard decisions	Other
hard problems	Generic
hard rules	Other
hardware	Generic
hash-tag recommendation task	Task
hashtag recommendation problem	Task
hbg	Method
hbg model	Method
hdag kernel	Method
hdags	Method
head grammars	Method
head motion variation	Other
head nods	Other
head-driven statistical parsing model	Method
head-to-head tests	Other
heavy occlusion	Other
help-desk applications	Task
hessian	Other
heterogeneous data modalities	Other
heuristic approach	Method
heuristic approaches	Method
heuristic learning  of  phrase translations	Method
heuristic principles	Method
heuristic rules	Method
heuristics	Method
hfo analysis	Task
hfo features	Other
hfos	Other
hidden conditional ordinal random field (h-corf) framework	Method
hidden layer	Other
hidden markov model	Method
hidden markov model (hmm)	Method
hidden markov model (hmm) and maximum entropy (maxent) classifiers	Method
hidden markov models	Method
hidden markov models (hmms)	Method
hidden space	Other
hidden variables	Other
hidden-variable assignments	Other
hierarchical (or other types of) relations	Other
hierarchical abstraction of the supervoxel graph	Task
hierarchical approaches	Method
hierarchical data structure	Method
hierarchical directed acyclic graph (hdag) kernel	Method
hierarchical lexicon	Other
hierarchical motion history histogram (hmhh) feature	Method
hierarchical perceptual sound organization	Task
hierarchical perceptual sounds	Material
hierarchical relations	Other
hierarchical sparse coding approach	Method
hierarchical structure	Other
hierarchically-structured terminology	Material
hierarchy of  phrasal patterns	Method
high confidence predictions	Other
high dimensionality space	Other
high frequency oscillations (hfos)	Other
high resolution imagery	Other
high-accuracy word-level alignment models	Method
high-capacity models	Method
high-density, low-power analog array	Other
high-dimensional continuous-state tasks	Task
high-dimensional data	Material
high-level concepts	Other
high-level program execution	Task
high-quality data	Material
high-resolution parallel inner-product computation	Task
high-resolution reconstructions	Task
high-resolution tensor space	Other
high-temporal resolution, intracranial eeg data	Material
higher dimensional (kernel) subspaces	Other
higher dimensional space	Other
higher-dimensional real or complex space	Other
higher-order cepstral coefficients	Other
highlight color analysis	Other
highlight detection	Task
highlight pixels	Other
highlighting of relevant information	Task
highly correlated inputs	Material
highly inflective languages	Material
highly varied  argument structures	Other
highly-curved manifolds	Method
hilbert style proof system	Method
hip hop lyrics	Material
histogram  of  keywords	Method
histogram information	Other
histogram-based interest point detectors	Method
histogram-based representations	Method
hk-closed	Other
hk-open	Other
hmdb51	Material
hmhh	Method
hmm	Method
hmm and max-ent models	Method
hmm tagger	Method
hmm training	Method
hmm with gaussian mixture observation densities	Method
hmm-based chunk tagger	Method
hmm-based speech synthesis system	Method
hmm-based tts system	Method
hmms	Method
homo-graphies	Other
homogeneous regions of foreground objects	Other
homographies	Other
homography	Other
honorifics	Material
horn clauses	Other
hough histogram	Method
hough voting	Method
html documents	Material
hub	Other
hubs	Other
human accuracy	Eval
human action	Other
human action recognition	Task
human action recognition system	Method
human agreement	Eval
human annotated text	Material
human annotation	Other
human biases in  summarization	Task
human classification	Task
human conceptual clustering techniques	Method
human created summaries	Material
human data	Material
human evaluators	Other
human interaction with data sources	Task
human judgment	Other
human language learning process	Task
human language technology	Method
human motion model	Method
human motion recognition	Task
human pose	Other
human study	Method
human template	Other
human transcription	Other
human transcriptions	Other
human understanding of natural language	Task
human-computer interaction	Task
human-machine communication	Task
human-machine interactions	Task
hybrid algorithm	Method
hybrid architecture	Method
hybrid model	Method
hybrid proba-bilistic model	Method
hybrid system	Method
hypergraph	Other
hypergraph regu-larization	Other
hypergraph regularization	Other
hyperparameters	Generic
hyperplane	Other
hyperplane algorithms	Method
hyperplane learning algorithms	Method
hyperplane of the learning algorithms	Other
hypertext mark-up language (html) technology	Method
hyponymy	Other
hypotheses graph	Other
hypothesis network	Method
hypothesize-and-test frameworks	Method
hypothesized object boundary fragments	Other
i-vector challenge	Material
ia	Method
iarpa-babel languages	Material
ibm model 3 alignment probabilities	Other
ibm models	Method
ibm models 1-2	Method
ibm statistical mt system	Method
ibm translation models	Method
icicle system	Task
ideal binary mask	Method
identification of 2-character and 3-character chinese names without title	Task
identification of non-local depenencies	Task
identification of paraphrases	Task
identification of the corresponding entity	Task
identifiers	Generic
identifying discriminative co-occurrence patterns	Task
identifying rare behaviours of interest	Task
identifying subtopic boundaries	Task
identity uncertainty	Task
identity-of-relations analyses	Task
idf-weighted word overlap	Other
idiosyncracies of the   sublanguage	Other
idiosyncrasies	Other
idiosyncratic texts	Material
ie	Task
ie module	Method
ie paradigm	Method
ie research	Task
ie-enhanced text browsers	Method
iemocap database	Material
ilimp	Method
ill-formed input	Material
illuminant	Other
illuminants	Other
illumination color uniformity	Other
illumination constraints	Other
illumination variation	Other
illumination-based constraints	Other
illumination-invariant image clustering	Task
illuminations	Other
im2gps	Material
image and video data	Material
image and video description datasets	Material
image and video interestingness benchmark datasets	Material
image appearance space	Other
image classification	Task
image color	Other
image completion	Task
image completion examples	Material
image composition (or mosaicing)	Task
image content	Other
image contour	Other
image coordinates	Other
image correspondences	Other
image data	Material
image deblurring	Task
image description	Task
image formation	Task
image in-painting	Task
image information	Other
image inpainting	Task
image map	Other
image matching	Task
image matting	Method
image modalities	Other
image of cortical processing	Other
image processing	Task
image processing techniques	Method
image registration methods	Method
image restoration	Task
image search engines	Method
image seg-mentation tasks	Task
image segmentation settings	Task
image segmentation systems	Method
image segmentation tasks	Task
image semantics	Other
image sequence	Material
image sequence description systems	Task
image sequence processing techniques	Method
image sequences	Material
image set classification algorithm	Method
image sets	Material
image size	Other
image-based representations	Method
image-to-text and text-to-image retrieval	Task
imageclef	Material
imagenet	Material
images	Material
images of popular music cd's	Material
imaging modalities	Other
implementation techniques	Method
implementations	Generic
implications	Generic
implicit intention component	Method
implicit reference resolution	Task
impossibility theorem	Method
ims	Task
in-domain  monolingual corpus	Material
in-domain word alignment	Task
inarbitrary distance measures	Method
incoming sound signals	Other
incomplete  knowledge  of  phrasal constructions	Other
incomplete  lexicon	Material
incomplete data	Material
incorporating enriched curvature information in stochastic approximation methods	Task
incremental description refinement	Method
incremental probabilistic parser	Method
independence	Other
independence model	Method
independent  classifier	Method
independent and relevant event-based extractive  mutli-document summarization approaches	Method
independent approach	Method
independent classifiers	Method
indexed languages	Material
indexing descriptors	Method
indicators	Generic
indicators of nuclearity	Other
indirect lighting	Other
individual rationality (ir)	Other
induced model	Method
inducing  semantic verb classes	Task
induction	Task
inductive decision tree learning	Method
inertial navigation system (ins)	Task
inference	Task
inference problem	Task
inference process	Method
inflected forms	Other
inflection	Other
inflexible quan-tization of single feature correspondences	Other
infomagnets	Method
information	Generic
information access	Other
information bottleneck  and  nearest neighbour  methods	Method
information distillation	Task
information extraction	Task
information extraction (ie)	Task
information extraction (ie) systems	Method
information extraction annotations	Other
information extraction system	Method
information extraction task	Task
information extraction tasks	Task
information extraction techniques	Method
information graphic	Other
information graphics	Other
information integration	Other
information navigation system	Task
information redundancy  in  multilingual input	Other
information retrieval	Task
information retrieval (elvircos)	Task
information retrieval engine	Method
information retrieval procedure	Method
information retrieval task	Task
information retrieval techniques	Method
information sources	Material
information-state model of reference	Method
informative frames	Other
informing	Other
inherent global ambiguity in shading	Other
inherent uncertainty of the estimation procedure	Other
inheritance-based lexica	Other
initial clusters	Other
initial, low-frequency shading estimate	Task
inner hair cell synapse	Other
inpainted parts	Other
inpainting process	Task
input	Generic
instance-level retrieval of images	Task
instance-level sbir	Task
instances	Generic
instantaneous linear mixtures	Other
insufficient fine-grained training data	Material
insufficient training data	Other
integrated learning system	Method
integrated spoken language system	Method
integrating  automatic q/a  applications into real-world environments	Task
integration and mutual disambiguation of multimodal input and output	Task
intel i860 chip	Other
intel-ligibility measures	Eval
intelligent computer-assisted morphological analysis (icall)	Task
intelligent environments	Task
intelligent interactive systems	Method
intelligent mobile agents	Method
intelligent tutoring systems	Task
intelligibility prediction	Task
intelligibility predictions	Task
intelligible neutral german speech	Material
intensity correspondences	Other
intensity data	Material
intensity distributions	Other
intensity estimation of facial expressions	Task
intensity of the observed facial displays	Other
intensity relations	Other
intenslonal logic translator lilt	Other
intentional structure	Other
inter-annotator agreement	Eval
inter-annotator variation	Other
inter-class penalty	Other
inter-expert variations	Other
inter-frame lip motion	Other
inter-sensor data ratio model	Method
interaction	Generic
interactions	Generic
interactive corpus exploration tool	Method
interactive disambiguation scheme	Method
interactive machine translation	Task
interactive mt	Task
interactive problem solving	Task
interactive question-answering (q/a) system	Method
interactively visualizing and directing the process  of  translating	Task
interchange lemma	Method
interdepen-dency models	Method
interest point detectors	Method
interesting-ness value	Other
interestingness prediction task	Task
interestingness prediction tasks	Task
interface	Generic
interfaces	Other
interference	Other
interference robustness	Eval
interlingua	Other
interlingual approach	Method
intermediate domain	Other
intermediate-level video representation	Method
internal  lexical and syntactical variation	Eval
internal and contextual information	Other
internal gazetteer feature	Other
internal model	Method
interpolation methods	Method
interpolation technique	Method
interpolative shading	Task
interpretation  of  compounds	Task
interpretation and generation of natural language	Task
interpreting  metaphors	Task
interrogatives	Other
interruptions	Other
intersection-over-union (iou) measure	Eval
interval algebra (ia)	Method
interventional distribution	Other
interventional distributions	Other
interventions	Other
intex	Method
intex system	Method
intolerable computational cost of bp	Other
intra-class com-pactness	Other
intra-class variability	Other
intra-class variations	Other
intra-sentential quality	Eval
intractable posterior inference	Task
intrinsic appearance parameters	Other
intrinsic geometry	Other
intrinsic image methods	Method
intrinsic object representation	Method
intrinsic object structure	Other
intrinsic representation	Method
intrinsic representation of a video frame	Method
intrinsic texture properties (albedo, shading, normal) of scenes	Task
intrinsic textures	Other
intrinsic topology of multidimensional continuous facial	Other
inverse hessian matrix	Other
ir system	Task
ir violations	Other
isolated 3d features	Other
isolated words	Other
isomorphic derivations	Other
isomorphic grammars	Method
isomorphic grammars approach	Method
italian and english verb subcategorization frames (scfs)	Other
iterative deformation of a 3–d surface mesh	Method
iterative procedure	Method
iterative solutions	Method
iterative sparse spectral clustering algorithm	Method
japanese	Material
japanese character strings	Other
japanese dictionary task	Task
japanese information extraction	Task
japanese language dictionary	Material
japanese natural language processing studies	Material
japanese nlp	Material
japanese patent claim sentences	Material
japanese sentence analyses	Task
japanese text	Material
japanese text processing	Task
japanese verb phrases	Material
javelin	Method
javelin system	Method
jintaccs messages	Material
joint classification and regression optimization objective	Other
joint eigenstructure	Other
joint embed-dings of images and text	Other
joint filter	Method
joint image filters	Method
joint intensity distribution	Other
joint intensity distributions	Other
joint matrix decomposition	Task
joint matrix triangularization	Task
joint model  of  argument frames	Method
joint motion estimation and segmentation	Task
joint optimization problem	Task
joint problem of non-rigid image registration and depth estimation	Task
joint source-channel transliteration model	Method
jointly gaussian likelihoods	Other
k-means	Method
k-median	Method
kalman filter	Method
kanal	Method
kaze features	Method
kb	Material
kds	Method
kds (knowledge delivery system)	Method
kernel density estimate	Method
kernel fukunaga-koontz transform	Method
kernel function	Method
kernel functions	Method
kernel space embedding	Other
kernel trick	Method
kernel-ized support vector machines	Method
kernels	Method
key prediction	Task
keypoint annotations	Method
keyword search	Task
keywords	Other
kikuchi approximation	Method
kikuchi expansion	Other
kikuchi region graph	Other
kitti2012 dataset	Material
kl-conc	Method
kl-one	Method
kl-one style representation	Method
kl-one-like knowledge representation systems	Method
knowledge	Generic
knowledge based systems	Task
knowledge bases	Material
knowledge engineering	Method
knowledge representation	Method
knowledge sources	Material
knowledge store	Other
knowledge-based and random selection procedures	Method
knowledge-based automated acquisition of grammars	Method
knowledge-based mechanisms	Method
knowledge-based techniques	Method
knowledge-independent method	Method
knowledgebases	Material
known distribution	Other
known motion	Other
korean	Material
korean newspaper articles	Material
korean phonological knowledge base system	Task
korean phonology structure grammar (kpsg)	Method
korean-english translation	Task
korean-to-english and a japanese-to-english dictionary	Material
korean-to-english dictionary	Material
korean-to-english machine translation system	Method
korean-to-japanese dictionary	Material
kpsg	Method
kullback-leibler distance	Method
kyoto city bus information system	Method
la-grangian mechanics	Method
label sequence models	Method
labeled directed graph	Method
labeled examples	Material
labeled training and unla-beled test data	Material
labeling curvilinear structure	Task
labelled bracket f-score	Eval
labelled data	Generic
labelme data set	Material
labial coarticulation effects	Other
lack of structures	Other
lack of structures in traditional n-gram models	Task
lack of temporal consistency	Other
lagrangian coherent structures (lcs)	Other
lagrangian particle dynamics	Method
language	Generic
language acquisition	Task
language assessment / correction application	Task
language corpus annotation scenario	Material
language functionalities	Other
language identification	Task
language independent modules	Method
language l	Other
language learning	Task
language learning model	Method
language model	Method
language model adaptation methods	Method
language model score	Other
language modeling of conversational telephone speech	Method
language modeling tasks	Task
language modelling toolkits	Method
language models	Method
language models (lms)	Method
language neutral meaning representation	Method
language of limited expressive power	Method
language processing modules	Method
language processing pipeline	Method
language processing systems	Method
language processing tasks	Task
language resource quality	Eval
language theories	Method
language tutoring application	Task
language understanding	Task
language understanding and generation modules	Method
large and imperfect data set	Material
large camera rotations	Other
large corpora	Material
large czech mwe database	Material
large datasets	Material
large margin estimation	Task
large margin piece-wise learning method	Method
large outlier percentages	Eval
large scale discourse-level annotation	Task
large treebank grammars	Method
large vocabulary continuous speech recognition	Task
large vocabulary speech recognition	Task
large-margin objective	Other
large-scale  acquisition of word-semantic information	Task
large-scale  out-of-domain corpus	Material
large-scale database	Material
large-scale grammars	Method
large-scale knowledge base	Material
large-scale logistic regression problems	Task
large-scale structures	Other
large-vocabulary csr	Method
large-vocabulary speech recognition	Task
laryngectomees	Other
laser ground truth data	Material
latent variable	Other
latent variable model	Method
latent variables	Other
latter	Generic
lattice	Other
lattice corpora	Material
lattice-based approach	Method
layers	Other
layers of distributed representations	Method
layout structures	Other
lcs	Other
lcs meaning components	Method
lcs representations	Method
lcs-marine	Task
leading system	Generic
learned confidence measures	Method
learned matrix	Other
learned metric	Other
learned representation	Generic
learner	Generic
learning algorithm	Method
learning algorithms	Method
learning and detection phases	Task
learning curve behavior	Other
learning imbalanced datasets	Task
learning in autonomous agents	Task
learning methodology	Method
learning methods	Method
learning phase	Task
learning the time-varying shape of a non-rigid 3d object	Task
learning video representation	Task
learning without external data	Method
learning-based approach	Method
least median of squares	Method
least square estimate	Method
least squares estimate (lse) method	Method
left corner parsing algorithm	Method
left-side dependents	Other
legal terminology	Material
legal text hierarchy	Other
lemma-based approach	Method
lemma-based model	Method
lemmatization	Task
lemmatized indexing	Method
lengthy semantic web documents	Material
level of agreement	Eval
levels of detail (lod)	Other
lexical acquisition systems	Method
lexical affinity	Other
lexical and syntactic features	Other
lexical approaches	Method
lexical category ambiguity	Other
lexical choice	Other
lexical cohesion-based approach	Method
lexical conceptual structure (lcs) representations	Method
lexical features	Other
lexical hierarchy	Other
lexical methods	Method
lexical probabilities	Other
lexical rules	Other
lexical similarity	Other
lexical structuring method	Method
lexical substitutions	Other
lexical translations	Task
lexical units	Other
lexical weighting  of  phrase translations	Method
lexical, syntactic, semantic, and structural information	Other
lexical-cohesion and conversational features	Other
lexical-functional grammars (lfg)	Method
lexical-syntactic forms	Other
lexicalized grammar	Method
lexicalized grammars of english	Method
lexically-induced relations	Other
lexico-syntactic knowledge	Other
lexicon driven processing	Method
lexicon grammar for polish (syntlex)	Method
lexicons	Generic
lexsys	Method
liaisons	Other
light field space	Other
light field stereo matching	Task
light field super-resolution	Task
light field triangulation	Task
light fields	Other
lighting	Other
lighting variations	Other
limited computational resources	Material
limited domain semantics	Other
limited training data	Material
limited-domain computer system	Method
limited-domain spoken-language task	Task
limited-memory stochastic block bfgs update	Method
limsi recognizer	Method
lincoln csr system	Method
line constraints	Other
line correspondences	Other
line drawings	Material
line-assisted graph-cut (lagc) algorithm	Method
linear and kernel svm	Method
linear classification	Task
linear combination	Method
linear combination of normally distributed hidden variables	Method
linear combination of products of normally distributed hidden variables	Other
linear convergence	Other
linear fkt	Method
linear fukunaga-koontz transform (fkt)	Method
linear manifold	Other
linear methods	Method
linear modeling	Method
linear or nonlinear discriminant subspace learning and classification	Task
linear relationships between observed variables	Other
linear support vector machine (svm) classifier	Method
linear-chain conditional random field (crf)	Method
linearity	Other
linearly interpolated language models	Method
linguistic and non-linguistic knowledge	Other
linguistic annotation  of  scfs	Task
linguistic concepts	Other
linguistic databases	Material
linguistic domain	Material
linguistic expressiveness	Other
linguistic generality	Other
linguistic information	Other
linguistic introspection	Method
linguistic knowledge discovery	Task
linguistic parser/generator	Method
linguistic pattern	Other
linguistic phenomena	Other
linguistic pos tagger and chunker	Method
linguistic processing	Task
linguistic representation	Method
linguistic resources	Material
linguistic rules	Other
linguistic structure	Other
linguistic structures	Other
linguistic theory	Method
linguistic tools	Method
linguistics	Material
link decisions	Task
link detection	Task
lipreading	Task
listen-communicate-show (lcs)	Task
lists of  botanical and zoological terms	Material
live cctv camera input	Material
live closed captions	Material
lm	Method
lm pruning	Task
lms	Method
lnmf	Method
lo-calization constraint	Other
lo-english or better a l0-unl dictionary	Material
local and holistic contexts	Other
local correspondence	Other
local correspondences	Other
local curve-element attributes	Other
local detection uncertainties	Other
local detection uncertainties of multiple shape candidates	Other
local deterministic search	Method
local features	Other
local histograms of oriented gradients (hogs)	Other
local maximum likelihoods	Other
local metrics of the semi-riemannian space	Eval
local mode of the similarity measure	Other
local non-negative matrix factorization (lnmf)	Method
local optimization	Method
local pattern context	Other
local phrase re-ordering	Task
local range	Other
local reconstruction algorithm	Method
local region descriptors	Method
local regions	Other
local search	Method
local segment contiguity models	Method
local segments	Other
local shapes	Other
local smoothness	Other
local structure  of  coherent text	Other
local subspace structure	Other
local temporal relationship of adjacent frames	Other
local tracker	Method
local tracking	Method
local trees	Other
local variables	Other
locality-sensitive hashing (lsh)	Method
localization accuracy and distinctiveness	Eval
localization accuracy and distinctiviness	Eval
localized features	Other
localized motion estimates	Method
localized phrase-based prediction model	Method
localizing functional objects	Task
locally inferred surface elements	Other
location grouping space	Other
location time	Other
locations of functional objects	Other
log partition function of a product distribution	Task
log(d) overheads	Other
log-likelihood	Other
log-linear (maximum-entropy) models	Method
log-linear and linear interpolation	Method
log-linear block bigram model	Method
log-linear combination	Other
log-linear models	Method
logic	Other
logic-based grammar formalism	Method
logical definition	Method
logical definition  of  minimalist grammars	Method
logical expression	Other
logical form	Other
logical form language	Other
logical formalism	Method
logical properties of contexts	Task
logical well-formedness conditions	Other
logistic softmax function of covariance-based region features	Other
logistic stick-breaking representation	Method
logon mt demonstrator	Method
long stereo video streams	Material
long-duration and complete occlusion	Other
long-duration and complete occlusions	Other
long-range motion cues	Other
long-range temporal dynamics	Other
long-range temporal interactions	Other
longman dictionary of contemporary english	Material
lookup table representations	Method
loose within-class shape similarity assumptions	Other
loss	Other
loss functions	Other
loss-aware predictions	Task
loss-aware predictions in image segmentation settings	Task
low bit rates	Other
low dimension feature vector	Other
low dimensional linear subspace	Other
low dimensional manifold	Other
low dimensional representation	Method
low error	Eval
low rank matrices	Other
low rank matrix	Other
low rank part	Other
low rank plus sparse structure	Other
low resource languages	Material
low-dimensional representation	Method
low-dimensional space (i-vectors)	Other
low-level computer vision problems	Task
low-level criterion	Eval
low-level driven image processing algorithms	Method
low-level feature analysis	Method
low-level feature representations	Method
low-level features	Other
low-level information	Other
low-rank matrix optimization	Task
low-resolution analog-to-digital conversion	Method
low-resolution images	Material
lower bound estimation	Method
lower-dimensional hidden space	Other
lpc based speech coders	Method
lpc excitation	Other
lpc vocoder	Method
lr(0) grammars	Method
lr-parser	Method
lr-parsers	Method
lsa-based and the cooccurrence-based word vectors	Other
lsa-based, cooccurrence-based and dictionary-based methods	Method
lsh	Method
lsp-mlp system (linguistic string project - medical language processor)	Method
lstm-based method	Method
lt (lf)	Method
ltag	Method
lucy	Method
lyric-based song sentiment classification	Task
lyric-based song sentiment classification task	Task
lyrics in music	Material
machine learning	Task
machine learning algorithms	Method
machine learning applications	Task
machine learning approach	Method
machine learning techniques	Method
machine reading	Task
machine reading system	Task
machine translation (mt) evaluation	Task
machine translation evaluation measures	Eval
machine translation output	Other
machine translation outputs	Other
machine translation pipeline	Method
machine translation system	Task
machine translation task	Task
machine translation tests	Other
machine translations	Task
machine transliteration/back-transliteration	Task
machine transliteration/backtransliteration	Task
machine-learning system	Method
machine-readable dictionaries (mrd's)	Material
machine-readable resources	Material
macro-average f1	Eval
macro-average f1 performance	Eval
mahalanobis distance	Task
main parser	Method
majority voting	Method
manifold analysis	Method
manifold learning methods	Method
manual acquisition  of  semantic constraints	Task
manual annotation process	Task
manual evaluation	Method
manual feature selection	Method
manual interaction	Other
manual judgement	Method
manual or semi-automatic methods	Method
manual transcription	Material
manual word alignments	Material
manually annotated data	Material
manually sense-tagged data	Material
manually verified phonetic transcriptions	Other
map estimation approach	Method
map estimation framework	Method
mapping  between  verbs	Task
mapping algorithm	Method
mapping score	Other
mappings	Other
marginalized denoising auto-encoders	Method
margins distribution	Other
margins theory	Method
marine weather forecasts	Task
markov chain monte carlo	Method
markov chains	Other
markov decision process	Other
markov model	Method
markov random field (mrf) models	Method
marks	Generic
massive window sampling	Method
massive, possibly multilingual, audio and textual document sources	Material
matching	Task
matching algorithm	Method
matching application on deformable surfaces	Task
matching local region features	Other
matching of cursive scripts	Task
matching textured scenes	Task
mathematical expressions	Other
mathematical formalism	Method
mathematical tools	Method
matrix rank degeneration	Other
mattes	Generic
maximization of  translation accuracy	Eval
maximum a posteriori estimation	Method
maximum eigenvalue	Other
maximum entropy	Method
maximum entropy classifier	Method
maximum entropy classifiers	Method
maximum entropy model	Method
maximum entropy model-based approach	Method
maximum entropy word alignment algorithm	Method
maximum entropy-based ranking model	Method
maximum likelihood	Other
maximum likelihood (ml) estimation method	Method
maximum likelihood criterion	Other
maximum likelihood estimate of the room full-band reverberation time	Method
maximum likelihood estimation problem	Task
maximum likelihood identity parameter vector	Other
maximum likelihood method	Method
maximum margin criterion	Other
maximum mutual information	Eval
maximum set coverage problem	Task
maximum term-weighted value	Eval
maximum-entropy model	Method
mbr decoders	Method
mbr decoding	Method
me-diamill	Material
mean absolute error	Eval
mean precision	Eval
mean-shift based clustering algorithm	Method
meaning  of the  tenses	Other
meaning equivalence	Method
meaning-entailing substitutability	Eval
means	Generic
measurable signals	Material
measure	Generic
measures	Generic
measures of speech	Eval
mechanical translation	Task
mechanism	Generic
mediaeval2010	Material
medical administrative purposes	Task
medical images	Material
medium-length speeches	Material
medium-sized image collection	Material
meeting context	Other
mel-frequency cepstral coefficients (mfccs)	Method
memo-functions	Method
memory	Other
memory capacity	Other
memory constraints.	Other
memory size	Other
memory-based learning chunker	Method
memory-based system	Method
meronymy	Other
mesh	Other
mesh connectivity requirement	Other
mesh relations	Other
message understanding conferences	Material
metagrammatical formalisms	Method
metaphor interpretation	Task
metarules (mps grammars)	Other
method to automatically acquire paraphrases	Method
methodology	Generic
metric	Generic
metric learning formulation	Method
metric learning literature	Other
metric weight constraint	Other
metrics	Generic
mfcc features	Method
mfccs	Method
mhi	Method
mi-cro phase shifting	Method
microblogs	Material
microphone vs. telephone channel	Other
military and civilian computer-based systems	Task
military and civilian systems	Task
military application tasks	Task
mimo	Other
mimo formalism	Method
minimal dfa	Other
minimal labeling problem (mlp)	Task
minimal overhead	Other
minimization of bayes risk	Task
minimum bayes-risk (mbr) decoding	Method
minimum bayes-risk framework	Method
minimum description length principle	Method
minimum description length principle (mdl)	Method
minimum empirical error	Other
mining procedure	Generic
minpath	Method
minpran	Method
miscommunication	Task
miscommunications	Task
mismatch	Other
missiles and chemical biological warfare	Material
missing data	Material
missing image structure	Other
missing low-level information	Other
missing point correspondences	Task
mit indoor-67 dataset	Material
mixed voicing speech	Material
mixed-initiative speech dialogue interactions	Method
mixed-signal paradigm	Method
mixing matrix	Other
mixture of viewpoints models	Method
mixtures of feature distributions	Other
mixtures of markov models	Method
mle reestimation algorithms	Method
mlps	Method
mobile military command and control	Task
mobile speech application	Task
mobile, intelligent agent	Method
modal language lt	Method
modal languages	Method
modality	Other
model design	Generic
model learning process	Task
model of grammatical processing	Method
model parameters	Other
model pruning	Task
model selection	Method
model space	Other
model testing	Task
model training	Task
model transfer	Other
model-based approach	Method
model-based approaches	Generic
model-based bundle adjustment algorithm	Method
model-based policy search approach	Method
model-free rl	Task
model-theoretic semantics	Other
modeling and recognition of human motion	Task
modeling and subtraction of such scenes	Task
modeling of the dynamic characteristics	Task
modeling problems	Task
modeling properties	Other
modelling rotated image textures	Task
models	Generic
models of author and title corruption	Method
models of shape variation	Method
moderate positive sample mining method	Method
modern computer games	Other
modes of variations	Other
modest false positive rates	Eval
modifier attachment	Other
modifiers	Other
modular  syntactic analysis system	Method
modulated phase shifting	Method
module	Generic
modules	Generic
mole	Other
monocular nonrigid 3d reconstruction	Task
monolingual and bilingual information	Other
monolingual dependency parse	Other
monolingual material	Material
monolingual parallel corpora	Material
monolingual ucg	Task
monolingual, unannotated text	Material
montague semantics	Other
montague's ptq	Method
monte carlo approach	Method
morpa	Method
morphemes	Other
morpho-syntactic and semantic characteristics	Other
morphological analysis	Task
morphological analysis problem	Task
morphological analyzer	Method
morphological and syntactic information	Other
morphological component	Method
morphological or syntactic features	Other
morphological parser morpa	Method
morphological parsing	Task
morphological variants	Other
morphologically rich languages	Material
morphosyntactic parser of l0	Method
mosaic	Task
mosaicing	Task
motion analysis	Task
motion estimation	Task
motion history image (mhi)	Method
motion information	Other
motion model	Method
motion of objects	Other
motion segments	Other
motion similarity	Other
motion trajectories	Other
motor control representation	Method
motor cortex	Other
motorbikes under planar rotations	Material
move selector	Method
move sorter	Method
move-tagged abstracts	Material
movie subtitles	Material
movies	Material
moving crowd	Other
mpt	Other
mpt-based classifier	Method
mrf energy function	Method
mrr	Eval
ms-l0 structure	Other
msg (modulation-filtered spec-trogram) auditory features	Other
msr- closed	Other
msr-close	Other
msr-open	Other
msrii	Material
mt architectural designs	Method
mt evaluation	Task
mt evaluation methods	Eval
mt evaluation techniques	Method
mt system	Method
mt system  design	Task
mt systems	Method
mt-based paraphrasing technique	Method
mu-project	Method
muc	Material
muc-3 evaluation	Eval
muc-6 and muc-7 english ne tasks	Material
multi engine machine translation system	Task
multi scale transforms	Other
multi-class problem	Task
multi-colored piece-wise uniform objects	Material
multi-component architecture	Method
multi-core machines	Other
multi-document summarization	Task
multi-event stories	Material
multi-field records	Material
multi-label classification approach	Method
multi-label classification problems	Task
multi-label potts model	Method
multi-label representation of the flow field	Method
multi-layer perceptrons (mlps)	Method
multi-level answer resolution algorithm	Method
multi-lingual evaluation task (met)	Task
multi-modal super-resolution and face recognition	Task
multi-modalities	Other
multi-page system	Task
multi-paragraph text	Material
multi-pathway mt architecture design	Method
multi-site common evaluation of speech, natural language and spoken language	Task
multi-site data collection paradigm	Method
multi-strategy and multi-source approach	Method
multi-strategy approach	Method
multi-strategy framework	Method
multi-tagging approach	Method
multi-task end-to-end joint classification-regression recurrent neural network	Method
multi-unit activity	Other
multi-view 3d model	Method
multi-view color constancy problem	Task
multi-view constraints	Other
multi-view datasets	Material
multi-view stereo	Material
multi-view video observations	Other
multiclass categorization	Task
multiclass perceptron	Method
multidimensional (multi-class) continuous facial behaviour data	Material
multidimensional chart parser	Method
multilayer neu-ral network	Method
multilingual corpus	Material
multilingual feature-level data sharing	Task
multilingual resources	Material
multilingual speech and language applications	Task
multilingual summaries	Task
multilingual text authoring	Task
multilingual tipster user interfaces	Other
multilingual training	Task
multilingual, multimedia data	Material
multilingual, speaker-independent, large vocabulary speech dictation	Task
multilingually aligned wordnets	Material
multimedia answers	Material
multimedia articulation of answers	Task
multimodal ambiguity resolution	Task
multimodal content	Material
multimodal dialog system	Method
multimodal integration	Task
multimodal interfaces	Task
multimodal parsing and understanding	Task
multimodal understanding	Task
multinomial distribution	Method
multinomial distributions	Method
multinomial or categorical distributions	Method
multiple and nested interactions	Other
multiple consecutive words	Other
multiple depth maps	Other
multiple dithered transformations	Other
multiple factor interactions of training tensor	Other
multiple instance learning (mil) formulation	Method
multiple layer of grammars	Method
multiple layer presentation	Method
multiple layers	Other
multiple layers of linear projections	Other
multiple matching surfaces	Other
multiple object tracking in dynamic scenes	Task
multiple parsing strategies	Method
multiple ptz camera sequences	Other
multiple standard datasets	Generic
multiple view acquisition	Task
multiple view video capture	Other
multiscale 2d feature detection and description algorithm	Method
multiscale feature extraction algorithm	Method
multisentential and multi-paragraph explanations	Other
multisentential discourse plans	Other
music scene analysis system	Method
musical sounds	Material
mutual information	Other
mwes	Other
mwes database	Material
n-ary relations	Other
n-best candidates of asr	Other
n-best sentence hypotheses	Other
n-best speech/language integration architecture	Method
"n-fold templated piped correction, or ntpc (""nitpick"")"	Method
n-gram language model	Method
n-gram models	Method
n-gram statistics	Method
n-gram transliteration model (n-gram tm)	Method
n-grams	Method
naive bayes classifiers	Method
nam	Material
nam and electrolaryngeal speech	Material
name identification	Task
named entity (ne) items	Other
named entity (ne) recognition (ner) system	Method
named entity (ne) tagging	Task
named entity annotations	Other
named entity corpora	Material
named entity task	Task
names	Other
narrative content	Material
national geographic documentary	Material
natural description logics	Method
natural gems	Other
natural images	Material
natural language (nl)	Material
natural language (nl) interfaces	Other
natural language applications	Task
natural language descriptions	Material
natural language environment	Other
natural language generation	Task
natural language generation community	Task
natural language generation system	Method
natural language generator	Method
natural language input	Other
natural language interfaces	Other
natural language interpretation	Task
natural language parsing (nlp)	Task
natural language presuppositions	Task
natural language processing (nlp)	Method
natural language processing (nlp) applications	Task
natural language processing (nlp) system	Task
natural language processing systems	Method
natural language processing tasks	Task
natural language question answering system	Method
natural language search engines	Method
natural language system	Method
natural language systems	Method
natural language tests	Task
natural language text	Material
natural language texts	Material
natural language understanding	Task
natural languages	Material
natural metric	Generic
natural number recognition task	Task
natural singing voice	Other
natural speech	Material
natural speech signals	Other
natural sublanguages  with  stereotyped text structure	Material
natural voice	Material
navigation solution	Task
na¨ıve bayes mixture models	Method
nca	Method
ne	Other
ne item	Other
ne items	Other
ne system	Method
near-bernoulli statistics	Other
near-optimal performance	Other
nearest neighbor	Method
nearest neighbor (nn) search	Task
negations	Other
negative feature vectors	Other
negative feedback	Other
negra corpus	Material
neighborhood graph structure	Other
ner problem	Task
network	Generic
neural network	Method
neural network classifier	Method
neural networks	Method
neuronal population vector (npv)	Other
neuronal processing	Task
news articles	Material
news commentary texts	Material
news reports	Other
news wire	Material
newspaper corpus	Material
newspaper text	Material
newspaper texts	Material
newswire documents	Material
newswire texts	Material
ngrams	Other
nist	Eval
nist and bleu automatic mt evaluation software	Eval
nist automatic content extraction (ace) task	Task
nist evaluation metric	Eval
nist score	Eval
nist sentence boundary detection task	Material
nist speaker recognition evaluations (sres)	Material
nitzan-paroush weighted majority	Other
nl	Material
nl evaluations	Task
nl requirements	Other
nlp problems	Task
nlp structures	Other
nlp system	Method
nlp tasks	Task
nlp-system for dutch (dutch medical language processor - dmlp)	Method
nmf	Method
nmf and pca methods	Method
nn search	Task
node	Other
nodes	Other
noise	Other
noise and reverberation robustness	Eval
noise conditions	Other
noise robustness	Eval
noise spotting capabilities	Task
noise-free and noisy data	Material
noise-handling mechanisms	Method
noises	Other
noisy and redundant attributes	Other
noisy channel framework	Method
noisy conditions	Other
noisy image classification	Task
noisy images	Material
noisy training dataset	Material
noisy-channel architecture	Method
nominal compounds	Other
nominal constituents	Other
nominals	Other
non verbal and multimodal communication	Task
non-audible murmur (nam)	Material
non-contiguous phrases	Material
non-deterministic parsing	Method
non-english (arabic) stemmer	Task
non-experimental data	Material
non-isolated minima	Other
non-linear extension of warca	Method
non-linear extensions of active shape models	Method
non-linear generalization	Method
non-linear nature	Other
non-linearities	Other
non-literal aspects of communication	Method
non-local configuration	Other
non-lr grammars	Method
non-monotonic reasoning	Task
non-native language essays	Material
non-negativity constraint	Other
non-parallel corpus	Material
non-quadratic approach	Method
non-rigid deformation	Other
non-rigid deformations	Other
non-rigid image registration	Task
non-rigid part of object state	Other
non-rigid structure from motion techniques	Method
non-rigid surface tracking	Method
non-rigid surfaces	Other
non-sequential tracking	Method
non-sequential tracking approaches	Method
non-speech interferences (nsi)	Other
non-subtractive (part-based) representation of images	Method
non-terminal symbol	Other
non-terminal symbols	Other
non-terminals	Other
non-uniform sampling strategies	Method
non-uniformity	Other
nonlinear diffusion filtering	Method
nonlinear generalization of factor analysis	Method
nonlinear monomials	Other
nonlinear optimization techniques	Method
nonlinear quality functions	Other
nonlinear scale space	Other
nonlinear scale spaces	Other
nonlinearities	Other
nonstationarity	Other
nonstationary chaos	Other
nonstationary chaotic behavior	Other
nonstationary events	Other
nonverbal behaviors	Other
normal-aware lighting difference	Other
normalized cuts framework	Method
normalized representation	Method
normative principles	Method
normf	Eval
notion of hypothesis sharing	Other
noun classifier associations (nca)	Method
noun wsd problems	Task
nouns	Other
np- and non-np-antecedents	Other
npv	Other
nsi	Other
nsi conditions	Other
nthu's statistic-based system	Method
ntpc	Method
nucleotide	Other
nucleotides in a dna sequence	Material
nullity of the semi-riemannian space	Other
number	Generic
number of hidden layers	Other
number of proposals	Other
numbering system	Method
numerical constraints	Other
numerical evaluation of the estimator	Task
numerical hybrid local and global mode-seeking tracker	Method
numerical integration scheme	Method
numerical optimization problem	Task
o(n6) time	Other
oa	Method
object boundaries	Other
object category	Other
object category detection datasets	Material
object category recognition	Task
object category representations	Method
object characteristics	Other
object detection	Task
object detector	Method
object intrinsic representation	Method
object model	Method
object pose estimation	Task
object pose information	Other
object poses	Other
object proposals	Other
object recognition	Task
object recognition task	Task
object recognition tasks	Task
object regions	Other
object rotation scenarios	Material
object shape	Other
object shapes	Other
object, scene, and action cat-egorization	Task
object, scene, and action recognition	Task
object-category detection datasets	Material
objective function	Other
objectness	Other
objects	Generic
observed variables	Other
occam's razor argument	Other
occluded image regions	Other
occluded parts inpainted	Other
occlusion	Other
occlusion labeling	Task
occlusion reasoning	Other
occlusions	Other
ocean surface microturbulence in ir image sequences	Task
ocean waves	Material
ocr   accuracy	Eval
ocr system	Other
ocr systems	Other
official rankings	Other
offset adaptation (oa) model	Method
olympic sports and ucf101 datasets	Material
on-line  lexical database	Material
on-line communities	Material
on-line cursive handwriting analysis and recognition	Task
on-line encyclopedias and dictionaries	Material
on-line handwriting	Task
on-line interference effects	Task
one	Generic
one sense per collocation observation	Method
one-class classification	Method
one-class classifiers	Method
one-dimensional (1-d) discrete fourier transform (dft)	Method
one-time look up method	Method
one-to-one teleconferencing applications	Task
ones	Generic
online action detection	Task
online learning process	Method
online left to right chart-parser	Method
online multiclass learning	Task
online news	Material
online sources	Material
onset neurons (ons)	Other
ontologies	Other
ontology	Other
ontoscore	Method
ooce domains	Task
oop	Method
oops	Task
oov identification	Task
oov words	Other
open-domain question answering	Task
open-domain question answering capability	Task
operable definition	Generic
operational foreign language tutoring	Task
operational semantics	Other
operations	Generic
operators	Generic
optimal alignment of non-rigid surfaces	Task
optimal co-occurrence pattern	Other
optimal control strategy	Method
optimal position policy	Method
optimal rule	Other
optimisation of the tree	Task
optimization of low-level motion estimators	Task
optimization problem	Task
optimization scheme	Method
optimum	Other
optimum iteration number	Other
or-library	Material
or-thonormality	Other
oral communication	Material
ordinal man-ifold	Other
ordinal manifold	Other
organizational and discourse strategies	Method
organizing reading materials	Task
orien-tations	Other
orientation	Other
orientations	Other
orientations of the object	Other
oriented object proposals (oops)	Task
original multilingual document	Material
original signals	Other
orthographic variants	Other
oscillation	Generic
oscillation between different scene interpretations and poor registration	Other
other	Generic
our method	Other
out-of-domain  bilingual corpus	Material
out-of-domain acoustic training data	Material
out-of-domain corpus	Material
out-of-domain training data	Material
out-of-vocabulary (oov) words	Other
out-of-vocabulary keywords	Other
outdoor surveillance settings	Other
outlier detection	Task
outlier removal	Task
outliers	Other
output  of black-box  ocr systems	Other
outputs	Generic
over copying	Other
over-fitting avoidance	Other
overall  architecture	Generic
overfitting	Other
overhead	Other
overlapping constraint	Other
overlapping speech	Other
overt case markers	Other
oxymoron	Other
p-cfg	Method
packed parse forests	Other
pagerank algorithm	Method
pairwise comparisons	Other
pairwise constraints	Other
paktus	Method
pan-tilt-zoom (ptz) cameras	Other
panoramic area	Other
paradigm	Generic
parallel concordances	Other
parallel corpora	Material
parallel corpora  of a  korean and english language pairs	Material
parallel corpus	Material
parallel data	Material
parallel english and chinese court judgments	Material
parallel structures	Other
parallel text	Material
parallel transport on manifolds	Other
parallelism	Other
paramax spoken language understanding system	Method
parameter determination	Method
parameter smoothing	Task
parameter space	Other
parameter space of translation, rotation and scale	Other
parameter training algorithm	Method
parameter tuning	Method
parameterized object state	Other
parameters	Generic
parameters of the acgmrf model	Other
parametric affinity model	Method
parametric model	Method
parametric representation of the motion	Task
parametrized deduction  process	Method
paraphrase	Other
paraphrase classification	Task
paraphrase classification accuracy	Eval
paraphrase corpus	Material
paraphrase examples	Material
paraphrase extraction and ranking methods	Method
paraphrase probability	Other
paraphrased questions	Material
paraphrases	Other
paraphrases acquisition	Task
paraphrasing	Method
paraphrasing method	Method
parse forest	Other
parse forest representation	Method
parse reduction	Task
parse reranking	Task
parse tree	Other
parse trees	Other
parse-trees	Other
parsed corpus	Material
parser	Method
parser  returning  montague analysis trees	Task
parser evaluation methods	Method
parser mdcc	Method
parsers	Method
parses	Generic
parsing  and  extraction tool	Method
parsing  of  korean	Task
parsing  spoken language	Task
parsing  written and spoken language	Task
parsing  written language	Task
parsing accuracy	Eval
parsing accuracy  rate	Eval
parsing algorithm	Method
parsing algorithms	Method
parsing data	Material
parsing flexibilities	Other
parsing method	Method
parsing process	Method
parsing strategies	Method
parsing technique	Method
parsing-as-deduction	Method
parsing-based ne rules	Other
part of speech (pos) tagging	Task
part of speech information	Other
part of speech tagging	Method
part-of-speech annotation	Task
part-of-speech tag sequences	Material
part-of-speech tagger	Method
part-of-speech tagging	Task
partial consistency	Other
partial occlusions	Other
partial scene segmentation	Task
partially-blurred-image classification and analysis framework	Method
particle-filter style tracker	Method
partition function	Other
pascal voc	Material
pascal voc 2006 dataset	Material
pascal voc 2006 datasets	Material
pascal voc 2007 dataset	Material
passes	Generic
passive  and the  binding of reflexives and pronouns	Other
passives	Other
patch-based clustering algorithms	Method
patches	Generic
patchwork property	Other
patchy  syntactic coverage	Other
pathological motion	Other
patient discharge summary (pds)	Other
patr-ii	Other
pattern engineering requirement	Other
pattern extraction scheme	Method
pattern recognition	Task
pattern-matching language	Other
patterns  around  cue phrases	Other
patterns  in  machine translation output	Other
paul	Method
payment rule	Other
pc-kimmo environment	Method
pca	Method
pcfg	Method
pcfg-la	Method
pcfg-la model	Method
pdtb	Material
pedestrian data	Material
pen trajectory	Other
penalized empirical risk minimization problems	Task
penalty	Eval
penn discourse annotation	Method
penn discourse treebank (pdtb)	Material
penn discourse treebank 2	Material
penn treebank	Material
penn treebank data	Material
penn treebank wsj	Material
penn wsj	Material
penn wsj corpus	Material
people	Other
people counting in crowded scenes	Task
people's trajectories and intents	Other
per	Eval
per-object 3d reconstructions	Task
per-vertex normals	Other
percentage of true inliers	Eval
perception of transparent objects	Task
perceptual evaluation of speech quality (pesq)	Eval
perceptual sound organization	Task
performance enhancing techniques	Method
permutation rules	Method
persistent dynamic behavior	Other
person ne	Other
person re-identification	Task
person re-identification datasets	Material
personal computers	Other
personal names	Other
personality-aware coupled reconstruction loss	Other
personalized aging process	Task
personalized aging progression	Other
personalized facial characteristics	Other
personalized parametric model (pose-driven avatar)	Method
pharmaceutical news archive	Material
phase locking in the auditory nerve (an)	Task
phases	Generic
phone duration models	Method
phone n-gram model	Method
phone-string classifier	Method
phonebook domain	Material
phonebook training corpus	Material
phonebook-trained baseline acoustic model	Method
phonetic recognition	Task
phonetic rules	Other
phonetically-based spoken language understanding system	Method
phonological and morphological rules	Other
phonological system	Task
photo-metric stereo	Material
photogeometric optimization	Method
photogeometric structured light	Method
photomet-ric stereo	Method
photometric and geometric data	Material
photometric calibration	Other
photometric methods	Method
photometric model	Method
photometric processing	Method
phrasal analysis rules	Other
phrasal and single word lexical paraphrases	Other
phrasal smt	Method
phrasal translation	Task
phrase  length	Other
phrase boundary heuristics	Method
phrase lo-calization	Task
phrase translations	Other
phrase-based models	Method
phrase-based smt models	Method
phrase-based statistical machine translation	Task
phrase-based statistical machine translation method	Method
phrase-based translation model	Method
phrase-based translation models	Method
phrase-based unigram model	Method
phrases	Generic
physical hypotheses	Other
physical models	Method
physical or geometric constraints	Other
physics-based segmentation algorithms	Method
physiology	Material
piece-wise planar scene	Other
piecewise-linear interpolant	Other
pipelined natural language generation (nlg) systems	Method
pipelined nlg architecture	Method
pivot mt	Task
pixel accuracy	Eval
pixel colors	Other
pixel-accurate semantic label maps	Other
pixel-domain super-resolution and recognition	Task
pixel-level component	Method
pixel-level labels	Other
pixel-resolution surface textures	Other
pixel-wise differences in image intensity	Eval
pixels/frame	Eval
pixelwise object probability	Other
pk-closed	Other
pk-open	Other
placing  commas	Task
planar patches	Other
planning	Other
planning algorithm	Method
planning systems	Task
planning-based architecture	Method
plsa	Method
plume	Method
plume's approach	Method
point cloud matching	Task
point clouds	Other
point correspondences	Other
point set matching	Task
point set registration algorithms	Method
polarization	Other
policies	Other
policy	Other
policy evaluations	Task
polish	Material
polymorphemic stems	Other
polynomial time	Other
polynomial time approximations	Method
polynomial time decoding algorithm	Method
polynomial time solution	Method
polysemic verbs	Other
polysemous word	Other
polysemous words	Other
polysemy	Other
pool models	Method
pooling of all the  speech data	Other
poorly-textured surfaces	Other
poorly-textured, deformable surface	Other
popularity	Other
pos correspondence	Other
pos learning	Task
pos level	Other
pos tag ambiguity	Other
pos tagging accuracy	Eval
pos tags	Other
pos-tag feature function	Other
pose	Other
pose estimation	Task
pose information	Other
pose invariance	Task
posed system	Method
position	Other
positioning accuracy	Eval
positions	Other
positions of  topic-bearing sentences	Other
positive and negative definition examples	Material
positive and negative examples	Material
positive feature vectors	Other
positive markers	Other
post referencing	Other
post-processing	Task
posterior	Generic
posterior inference	Task
posterior shape model	Method
posteriori bound	Other
pourpre	Eval
power consumption	Eval
practical algorithms	Method
pragmatic aspects	Other
pragmatics processing	Task
prague dependency treebank	Material
prague dependency treebank 2.0	Material
praguian dependency-based approach	Method
prc adaptive knowledge-based text understanding system (paktus)	Method
pre-processing step	Method
pre-registered image pairs	Material
pre-training	Method
preceding nucleotides	Other
preceeding  text	Other
precision	Eval
precision rate	Eval
predicate-argument structures	Other
predicative information	Other
predicted shape prior	Other
predicting  segment boundaries	Task
predicting  subtopic boundaries	Task
predicting image or video interestingness	Task
predicting people's trajectories	Task
predicting top-level and predicting subtopic boundaries	Task
predicting top-level boundaries	Task
predicting top-level topic shifts	Task
prediction model	Method
prediction techniques	Method
predictions of intelligibility	Task
predictive models	Generic
predictive questioning	Method
predictors of intelligibility	Method
predominant senses	Other
premature  ambiguity resolution	Other
preparing a segmented corpus	Task
preprocessing modules	Method
presuppositional nature	Other
pri-ori knowledge	Other
primal and dual svms	Method
primal-dual algorithm	Method
priming	Other
primitive connectivity	Other
princeton wordnet	Material
principal components analysis	Method
principal components of the texture	Other
principled and provable solution	Method
principles	Generic
printed text	Material
prior	Generic
prior 2d-to-3d association	Other
prior information	Other
prior knowledge	Other
prior knowledge of intrinsic parameters of the ptz camera	Other
prior nlp	Task
prior on natural images	Other
prior on the distribution of natural images	Other
prior structure	Other
priori	Other
priori geometric constraints	Other
priori knowledge	Other
priori linguistic or phonetic knowledge	Other
priority-based message scheduling	Method
priority-bp	Method
priors	Other
priors  in  conditional loglinear models	Other
probabilistic citation grammar	Method
probabilistic context-free grammar	Method
probabilistic context-free grammar (pcfg)	Method
probabilistic context-free grammars	Method
probabilistic decision tree	Other
probabilistic decision trees	Other
probabilistic finite automata	Method
probabilistic finite automaton	Other
probabilistic framework	Method
probabilistic horn clauses	Other
probabilistic model	Method
probabilistic models	Method
probabilistic parser	Method
probabilistic predictions of the expected background	Task
probabilistic shape knowledge	Other
probabilistic spectral mapping	Method
probabilistic synchronous dependency insertion grammar	Method
probabilistic translation models	Method
probability distribution	Other
probability distributions	Other
probability-based scoring function	Method
problem	Generic
problem solving	Method
problems	Generic
procedural systemic grammar	Method
procedure	Generic
procedures	Generic
process model	Method
process models	Method
processing	Generic
processing module	Method
processing modules	Method
processing paradigm	Generic
product analy-sis	Method
product analysis	Method
productive affixations of derivational and inflectional suffixes	Other
productive rules of interpretation	Other
program	Generic
programmable algorithm	Method
programming language	Other
projection cone	Other
projections	Other
projective reconstruction	Task
projective unifocal, bifo-cal, and trifocal tensors	Method
prolog	Other
prolog   subset of logic	Other
prolog form	Other
pronominal anaphora resolution module	Method
pronominalization	Other
pronoun resolution	Task
pronouns	Other
pronunciation variation	Task
propbank	Material
proper names, numerical and temporal expressions	Other
proper nouns	Other
proportion problem	Other
proposal	Generic
proposal generation methods	Method
proposal generation problem	Task
proposition bank data	Material
propositional language of context	Other
propositional logic of context	Other
protocol analysis	Task
prototype  concordancer	Method
prototype chip	Other
prototype natural language system	Method
prototype system	Generic
proximity matrix	Other
pruning criteria	Other
pseudo-muscular animation schema	Method
psi-klone system	Method
psy-chophysical and machine learning techniques	Method
psycholinguistic literature	Other
ptz camera	Other
ptz cameras	Other
public  databases  of  proper names  and  toponyms	Material
publication	Other
punctuation	Other
pushdown automaton	Method
pustejovsky's principles	Method
pólya-gamma augmentation	Task
q&a system	Task
q&a systems	Task
q-learning	Method
q/a	Method
qa system	Method
qcn	Method
qcns	Method
qcns of ia and rcc-8	Method
quadratic eigenvalue problem	Task
quadratic quantities of metric tensors	Other
quadratic time	Other
qualitative constraint network (qcn)	Method
qualitative information	Other
qualitative knowledge	Other
qualitative prior	Other
qualitative prior knowledge	Other
qualitative spatial constraints	Other
qualitative temporal and topological relations	Other
qualitative user evaluation	Eval
quality	Eval
quality  of  utterances	Eval
quality controls	Method
quality improvement	Task
quality measure	Eval
quality of separation	Eval
quantification over events	Other
quantified sentences	Material
quantifying noun groups  in  german	Task
quantisation techniques	Method
quantitative metrics	Eval
quantitative prior	Other
quantization	Other
quasi closed-form solution	Method
quasi-destructive scheme's ability	Other
quasi-newton method	Method
query optimisation	Method
query terms	Generic
question answering	Task
question answering (qa) systems	Method
question answering system	Method
question answering systems	Method
question classification  and  sentence alignment tasks	Task
question mark	Other
question, passage, and/or answer levels	Other
question-answer pairing	Task
question-answering capability	Other
question-focused sentence retrieval	Task
rainform messages	Material
random access	Other
random modulation scheme	Method
random projection trees	Method
random sampling	Method
random statistics	Other
random-projection based methods	Method
randomized model verification	Task
randomized sentence-plan-generator (spg)	Method
randomly generated compressed form of the hessian	Other
range concatenation grammar [rcg] formalism	Method
range concatenation languages [rcl]	Other
rank	Other
rank minimization	Method
rank problem	Task
rank-hlapsvm	Method
ranking  blog posts	Task
ranking  word pairs  in order of  semantic distance	Task
ranking algorithm	Method
ranking function	Other
ranking learning problem	Task
ranking problems	Task
ranking rules	Other
ranking tasks	Task
rankings	Other
ranks	Other
ransac	Method
ransac techniques	Method
rapid adaptation technique	Method
rapid search	Method
rare behaviours of interest	Other
rareas	Method
rate of ex-post ir violations	Eval
rational quartic curve	Other
raw corpus	Material
raw f0 contours	Other
raw spatiotemporal signals in videos	Material
raw text	Material
raw text  in  french	Material
ray space	Other
rcc-8	Method
rcg	Method
rcgs	Method
rcl parser	Method
rcl parsers	Method
re-active agent	Method
reaction time	Other
read speech	Material
reading and learning	Task
real  dialogue data	Material
real data	Material
real data sets	Material
real datasets	Generic
real image data	Material
real quadratic form	Other
real scene change mask	Other
real scene changes	Other
real scenes	Material
real-life trials	Other
real-time statistical voice conversion (vc)	Method
real-time system	Method
real-time vc	Method
real-valued features	Other
real-world action recognition problems	Task
real-world data analysis	Task
real-world datasets	Material
real-world images	Material
real-world robust depression detection	Task
real-world tasks	Task
realistic acquisition	Task
reasoning	Task
recall	Eval
recall and precision metrics	Eval
recall rates	Eval
receiving operating curve	Eval
recognition	Task
recognition and classification of proper names, numerical and temporal expressions	Task
recognition and retrieval applications	Task
recognition approaches	Method
recognition errors	Eval
recognition network	Method
recognition of extra-grammatical input	Other
recognition of proper nouns	Task
recognition process	Method
recognition quality	Eval
recognition rates	Eval
recognition scheme	Method
recognition scores	Eval
recognition system	Method
recognition task	Task
recognition tasks	Task
recognition technology	Method
recognition-time adaptation techniques	Method
recognizing  noun phrase chunks	Task
reconstructing the motion of a 3d articulated tree	Task
reconstruction process	Method
records	Material
recovered surface detail	Other
recovery	Task
recovery of shading and textures	Other
recovery technique	Method
recurrent neural networks	Method
recursive ascent parsers	Other
recursive descent parser	Method
reduced drift	Other
reduced il formulae	Other
reducing  language model (lm) size	Task
reduction in the search space	Other
reduction of out-of-vocabulary items	Other
redundancy elimination problem	Task
redundant copying	Other
redundant turns	Other
reduplication	Other
reduplications	Other
reestimation formulas	Other
reference failures	Other
reference model	Method
reference problems	Task
reference time	Other
reference times	Other
reference translations	Task
referential elements	Other
referential information	Other
referring expressions	Other
reflection	Other
reflections	Other
reflections in image sequences	Other
reflexive pronouns	Other
refractive indices	Other
reg-ularization	Other
regards mismatches	Other
region connection calculus (rcc)	Method
region graph	Other
region selection algorithm	Method
region-classifiers	Method
region-level component	Method
region-wise training and classification	Method
regions of similar color	Other
registered tensors	Other
registration	Task
registration criteria	Eval
registration process	Method
regressed-to values	Other
regression optimization	Task
regression problems	Task
regression-based techniques	Method
regular expressions	Other
regular-izer	Other
regularization	Other
regularized empirical risk minimization (erm) algorithm	Method
regularizer	Method
regularly-shaped dis-joint subgraphs	Other
reinforcement learning (rl)	Task
rejection rate	Eval
relation extraction	Task
relational database	Material
relational probability model	Method
relations	Generic
relations  between  representations	Task
relations between  named entities	Other
relationships	Other
relative clauses	Other
relative entropy	Method
relative error rate reduction	Eval
relative frequency of occurrence	Other
relative geometry	Other
relative pose of two calibrated or uncalibrated non-overlapping surveillance cameras	Task
relative positioning	Other
relative positions	Other
relative rotation	Other
relative translation	Other
relevance	Eval
relevant approach	Method
relevant information	Generic
relight-ing of free-viewpoint rendering	Task
relighting	Task
remarkable feature	Other
rendering of occlusions	Task
repeatability	Eval
representation	Generic
representations	Generic
representative techniques	Generic
representative training data	Material
representing and reasoning about qualitative temporal and topological relations	Task
representing images with layers	Method
reproduction of fine surface detail	Other
reranking approaches	Method
reranking task	Task
resampling pairwise constraints	Task
research	Generic
resolution	Eval
resolution component	Method
resolutions	Other
resource	Generic
resource sensitive logic	Other
resource-frugal approach	Method
resource-limited domains	Material
resources	Generic
respectful words	Other
responsivity	Other
restricted domain parser	Method
restricted natural language	Other
restricted vocabulary	Other
restricted-domain parsing	Task
restrictive statements	Other
results	Generic
rete and treat algorithms	Method
retrieval	Task
retrieval  of arbitrarily long  phrases	Task
retrieval accuracy	Eval
retrieval approach	Method
retrieval effectiveness	Eval
retrieval of small, rotated objects	Task
retrieval process	Method
retrieval quality	Eval
retrieval time	Eval
retrieving rotation-invariant texture features	Task
reverberant enclosures	Other
reverberant environments	Other
reverberated speech utterance	Other
reverberation	Other
reverberation time	Other
revision	Other
revision component	Method
reward	Eval
reweighted kikuchi approach	Method
reweighted objective function	Other
reweighted version of the kikuchi approximation	Method
reweighted version of the sum product algorithm	Method
rewriting systems	Method
rgb and depth images	Material
rhetorical functions	Other
rhetorical moves  of  argumentation	Method
rhetorical patterns	Other
rhetorical structure	Other
rhyming lyrics	Material
rhythm	Material
rich meta-data	Material
rich morphology	Other
rich motion information	Other
rich spatial-temporal structures	Other
richly textured scenes	Material
riemannian framework	Method
right-side dependencies	Other
right-side nominal dependents	Other
right-side verbal dependents	Other
rigid and non-rigid transformations	Other
rigid component	Method
rigid structure-from-motion	Other
rigidly-moving lambertian object	Material
rina	Method
rm and atis csr tasks	Task
rm task	Task
robust  communication procedures	Method
robust  interactive method	Generic
robust  probabilistic parsing models	Method
robust  statistical parser	Method
robust 3d reconstruction	Task
robust and high-performance speech recognition system	Method
robust automatic speech recognition	Task
robust cnn	Method
robust deep metrics	Other
robust estimation	Task
robust estimation procedure	Method
robust explanation system	Method
robust operator	Method
robust pca	Method
robust principal component analysis (robust pca) problem	Method
robust same-identity likelihood	Method
robust spatial verification	Task
robust speaker doa estimation algorithm	Method
robust visual tracking	Task
robust-ness	Eval
robust-ness requirement in image understanding	Task
robustness	Eval
robustness problems	Task
rod-tv	Method
roget's thesaurus	Material
role linking	Task
root	Other
root word lexicon	Material
rotation	Other
rotation invariant property	Other
rotation of image textures	Other
rotation-invariant features	Other
rotational speed of the engine	Other
rotations	Other
routing	Task
rule	Other
rule application	Method
rule-based and example based machine translation modules	Method
rule-based approach	Method
rule-based heuristics	Method
rule-based learning algorithm	Method
rule-based sentence planners	Method
rule-based systems	Method
rule-based translation systems	Method
rule-invocation strategies	Method
rule-invocation strategy	Method
rule-reduction algorithm	Method
rules  of a  deterministic grammar	Method
run time	Eval
russian	Material
s-vsm model	Method
sae	Method
sae structure	Method
salient image features	Other
sampled pairwise constraints	Other
sampled parameter space	Other
sampling	Method
sampling probabilities	Other
sampling process	Other
sampling windows	Other
san francisco	Material
sar (synthetic aperture radar	Other
savings of shortcut links	Task
scalability	Eval
scale	Other
scale market-1501	Material
scanned-document content retrieval	Task
scanning method	Method
scanning resolution	Other
scape method	Method
scarce  resources	Material
scenario consistency	Other
scenario templates	Other
scene analysis problem	Task
scene classification	Task
scene description	Other
scene discontinuities	Other
scene geometry	Other
scene representation	Method
scenes descriptions in natural language	Task
scfs	Other
scfs distributions	Other
schematic variables	Other
scheme	Generic
schrödinger distance transform (sdt) representation	Method
science and engineering fields	Task
scientific articles	Material
scope ambiguity	Other
sdt representation	Method
search	Task
search algorithm	Method
search algorithms	Method
search engine	Method
search engines	Method
search heuristics	Method
search procedure	Generic
search space	Other
search tool	Method
second approach	Generic
second language and cognitive skill acquisition	Task
second pass recognition	Generic
second-order vector cooccurrence algorithm	Method
security domain	Task
security systems	Task
sediment transport	Task
segmen-tation algorithms	Method
segment contiguity	Other
segment order	Other
segment order-sensitive methods	Method
segment-based approach	Method
segmental k-means algorithm	Method
segmentation bakeoff	Other
segmentation hierarchy levels	Other
segmentation of complex scenes	Task
segmentation of high density crowd flows	Task
segmentation stage	Method
segmentations	Other
segmented corpus	Material
segmenting feature points of piece-wise planar structures	Task
segmenting sequential data	Task
segments	Generic
selection of articulatory targets	Other
self-occlusion	Other
semantic	Other
semantic analyzer	Method
semantic and pragmatic level	Other
semantic and syntactic information	Other
semantic annotation	Method
semantic caseframe instantiation	Other
semantic classification	Method
semantic coherence	Other
semantic components	Method
semantic constraints	Other
semantic construction of noun phrase	Task
semantic criterion	Eval
semantic dependencies f1	Eval
semantic distance	Other
semantic domain models	Method
semantic frame	Other
semantic grammar	Method
semantic image retrieval	Task
semantic information	Other
semantic interpretation	Task
semantic interpretation and reasoning of diagrams	Task
semantic labels	Other
semantic object classes	Other
semantic relations	Other
semantic representation	Method
semantic role labeling	Task
semantic roles	Other
semantic similarity measures	Eval
semantic video segmenta-tion	Task
semantic web documents	Material
semantic-oriented nlp applications	Task
semantically annotated corpus	Material
semantically classifying   undisambiguated scf data	Task
semantically related words	Other
semantically rich, large-scale knowledge bases	Material
semantics	Other
semcor  and  senseval-3 data sets	Material
semi-riemannian discriminant analysis (srda)	Method
semi-riemannian geometry	Method
semi-riemannian manifold	Other
semi-riemannian metrics	Eval
semi-riemannian space	Other
semi-supervised learning	Task
semi-supervised learning framework	Method
semi-supervised methods	Method
semicolon	Other
semiphone modeling	Method
sense coverage	Eval
sense priors	Other
sense priors  of  words	Other
sense resolution	Task
sense-tagged training data	Material
senseval  series of workshops	Material
senseval-2 english lexical sample task	Material
senseval-2 nouns	Other
senseval-3 chinese lexical sample task	Material
senseval2	Material
sentence ambiguities	Other
sentence analysis	Task
sentence boundary detection	Task
sentence co-occurrences	Other
sentence condensation	Task
sentence condensation systems	Method
sentence extraction	Method
sentence plan	Other
sentence planner	Method
sentence planning	Task
sentence plans	Other
sentence retrieval problem	Task
sentence scoping	Task
sentence-aligned corpus	Material
sentence-aligned parallel corpus	Material
sentence-boundary-crossing representation	Task
sentence-by-sentence error correction method	Method
sentence-level and text-level anaphora	Other
sentence-level correlation	Eval
sentence-level semantic equivalence classification	Task
sentence-plan-ranker (spr)	Method
sentential paraphrases	Material
sentiment	Other
sentiment classification	Task
sentiment keywords	Other
sentiment vector space model (s-vsm)	Method
separation accuracy	Eval
separation margin	Other
separation method	Method
separation quality	Eval
sequence kernel dimension reduction approach (s-kdr)	Method
sequential and non-sequential tracking approaches	Method
sequential models	Method
sequential tracking in local segments	Task
serial algorithm	Method
set based similarity measure	Eval
sex-dependent models	Method
sfm pipelines	Method
shallow linguistic features  of  questions	Other
shallow mapping	Method
shallow processing	Method
shallow techniques	Method
shape	Other
shape alignment	Other
shape constrained image segmentation	Task
shape information	Other
shape matching problem	Task
shape motion	Other
shape reconstruction	Task
shape representation	Method
shape template	Other
shape tracking	Task
shapes	Other
shapes and the poses of transparent objects	Other
shapes of the objects	Other
shapes of the proposals	Other
shared derivation forest	Other
shared lexical information	Other
sharp error estimates	Method
shift-reduce dependency parsers	Method
short support set	Other
short supports	Other
shortgac	Method
shortstr2	Method
si	Task
si corpus	Material
si recognition	Task
si-nets	Method
side information	Other
sift	Method
sight-impaired users	Other
signal dictionary	Other
signal processing	Task
signal-based document processing functionality	Task
signals	Generic
significance	Other
sii measure	Eval
silent speech enhancement	Task
silent speech interface	Other
silva	Method
similar context features	Other
similar semantic properties	Other
similarities	Generic
similarity  between  words	Other
similarity measure	Eval
similarity measures	Method
similarity-driven transfer system (simtran)	Method
simple image regions	Other
simple tabular reduction algorithm str2+	Method
simulated and real reverberant environments	Other
simulated construction	Task
simulated data	Material
simulated signals	Material
simultaneous dynamic recognition	Task
simultaneous language model	Method
singing voice characteristics	Other
single depth sensor	Other
single modal low-resolution face image	Material
single modalities	Other
single-image highlight removal method	Method
single-linkage	Method
single-snippet answers	Other
single-strategy parsers	Method
single-view depth videos	Material
singularity problem	Other
sir	Eval
situated delegation-oriented dialog paradigm	Method
sizes	Other
sketch-based image retrieval application	Task
sketching strategies	Method
slave camera	Other
slavic language	Material
slavonic languages	Material
slice locations	Other
sliding window design	Method
slipper	Generic
slovak	Material
sls	Method
sls systems	Method
small, domain-specific corpus	Material
small-sample-size	Other
small-scale  in-domain corpus	Material
small-sized  bilingual corpus	Material
small-to-large scale grouping procedure	Method
smallest meaning-bearing units of language	Other
smartkom architecture	Method
smartkom demonstrator	Method
smooth motion	Other
smoothing	Method
smoothing of discrete functions	Method
smoothness	Other
smt algorithms	Method
smt models	Method
smt system	Method
smt-style stochastic transduction grammar	Method
social and cognitive psychology	Other
social media	Material
soft natural sounding speech	Material
soft, binary mattes	Other
software	Generic
software library	Method
solution	Generic
solutions	Generic
song lyric	Material
song lyric document	Material
song lyrics	Material
sound quality	Eval
source dependency parse	Other
source interval projections	Method
source-language   dependency parser	Method
source-separated musical notes	Material
space of candidate regions	Method
space of densities	Other
space-time interest point detection	Task
spanning edges	Other
sparse and dense detection maps	Other
sparse data	Material
sparse residual	Other
sparse se-lectional preferences	Other
sparsity	Other
sparsity of sources	Other
sparsity of the feature space	Other
spatial and temporal artefacts	Other
spatial and temporal intensity variation	Other
spatial attributes  of the  entities	Other
spatial concepts	Other
spatial descriptions	Other
spatial gradients	Other
spatial information	Other
spatial nonuni-formity	Other
spatial overlap	Other
spatial relationships	Other
spatial similarity	Other
spatial verification	Task
spatial, temporal and periodic information	Other
spatially complex asl phenomena	Other
spatially localized, parts-based subspace representation of visual patterns	Task
spatially-indexed and scale-indexed data structure	Other
spatio-temporal continuity	Other
spatio-temporal over-segmentation	Other
spatio-temporal video segmentation	Method
spatio-temporal video segmentation algorithm	Method
spatio-temporal video tube	Other
speaker adaptation	Task
speaker adaptation (sa)	Task
speaker doa cues	Other
speaker doa estimation accuracy	Eval
speaker group modeling	Task
speaker verification system	Method
speaker's gaze information	Other
speaker's intention	Other
speaker-independent (si) training  of  hidden markov models (hmm)	Task
speaking method	Method
special-purpose constraint propagation algorithms	Method
specialized parsing techniques	Method
specialized regression problem	Task
specific heuristics	Method
specifications	Generic
specificity	Eval
spectra	Other
spectral clustering	Method
spectral clustering algorithm	Method
spectral clustering based approach	Method
spectrum differential	Other
spectrum information	Other
specular reflection	Other
speech	Material
speech acts	Other
speech and gesture streams	Material
speech and text image processing	Task
speech and text understanding	Task
speech and text-image recognition	Method
speech containing acoustic noise	Material
speech cues	Other
speech data	Material
speech enhancement systems	Method
speech f0 contours	Other
speech intelligibility index (sii)	Eval
speech knowledge	Other
speech or text input	Other
speech processes	Material
speech processing	Task
speech quality	Eval
speech recognition	Task
speech recognition  and  synthesis system	Task
speech recognition  applications	Task
speech recognition  output	Other
speech recognition (sr)	Task
speech recognition accuracies	Eval
speech recognition and understanding systems	Task
speech recognition hypotheses	Other
speech recognition hypotheses (srh)	Other
speech recognizer	Method
speech segmentation	Task
speech sparsity	Other
speech syntax	Other
speech synthesis systems	Method
speech time	Other
speech understanding	Task
speech understanding (su)	Task
speech-based depression detection	Task
speech-based information retrieval (ir)	Task
speech-based information retrieval system	Task
speech-search algorithm	Method
speed	Other
speed and related states of the vehicle	Task
speed measurements	Other
speed-up element	Method
spelling correction	Task
spelling errors	Other
sphere	Generic
spoken corpora	Material
spoken dialogue	Task
spoken dialogue system	Method
"spoken dialogue system "" dialogue navigator for kyoto city """	Task
spoken language	Material
spoken language corpus	Material
spoken language system	Method
spoken language system domains	Material
spoken language systems (sls)	Task
spoken language technology	Method
spoken language understanding	Task
spoken language understanding system	Method
spoken multiparty dialogue	Material
spontaneous facial affect data	Material
spontaneous speech understanding	Task
spot	Method
spr	Method
square-root density	Other
sre	Material
sre series	Material
srhs	Other
stabler's formalization  of  chomsky's minimalist program	Method
stack	Other
stacked auto-encoder architecture	Method
stacked auto-encoders (sae)	Method
staged pre-training strategy	Method
stand-alone go player	Other
standalone system	Method
state of the art methods	Generic
state transitions	Other
state-of-the-arts	Generic
statement of generalizations	Other
static cameras	Other
static hamilton-jacobi equation	Other
static or quasi-static structures	Other
static schrödinger equation	Other
statistical alignment models	Method
statistical alignment techniques	Method
statistical analyses	Other
statistical analysis	Method
statistical and constraint-based disambiguation	Task
statistical approach	Method
statistical approaches	Method
statistical classification	Method
statistical conversion process	Method
statistical feature functions	Other
statistical generation	Task
statistical information	Other
statistical learning	Method
statistical learning mechanisms	Method
statistical learning model (slm)	Method
statistical learning perspective	Method
statistical machine learning algorithm	Method
statistical machine translation   quality	Eval
statistical machine translation (mt)	Task
statistical machine translation system	Method
statistical machine translation tool kit	Method
statistical method	Method
statistical methods	Method
statistical model	Method
statistical model of short-term log-energy sequences	Method
statistical models	Method
statistical models  of  wh-questions	Method
statistical mt	Method
statistical mt architectures	Method
statistical mt systems	Method
statistical n-gram language models	Method
statistical parameters	Other
statistical parser	Method
statistical profile	Generic
statistical ranking	Method
statistical relationship	Generic
statistical sentence generation	Task
statistical singing voice conversion (svc) technique	Method
statistical techniques	Method
statistical translation model	Method
statistical word alignment models	Method
statistically learned prior knowledge	Other
stemmer	Method
stemming model	Method
step-size and eligibility trace parameters	Other
stereo algorithm	Method
stereo images	Material
stereo matching	Task
stereo vision	Task
stereotypic dialogue	Material
stochastic attention networks	Method
stochastic attention-based models	Method
stochastic block bfgs updates	Method
stochastic dual coordinate ascent (sdca)	Method
stochastic gradient descent algorithm	Method
stochastic gradient estimates	Task
stochastic gradients	Other
stochastic optimization algorithms	Method
stochastic output selection	Task
stochastic parsers	Method
stochastic processes	Method
stochastic tree-to-tree transducer	Method
stochastic variance reduced gradient (svrg)	Method
stochastic, graph-based method	Method
stopping criterion	Other
storage media and networks	Task
story link detection	Task
story-telling	Other
str2+	Method
straight c code	Other
strategies	Generic
strategy	Generic
stratified sampling	Method
streaming skeleton data	Material
streaming video dataset	Material
strict compositionality	Other
strictly syntactic cross-serial agreement	Other
string similarity	Other
strings	Other
structural and lexical dependencies	Other
structural information	Other
structural or numerical constraints	Other
structure  and  surface representation  of  domain entities	Other
structure of a diagram	Other
structure of communicative context	Other
structure of diagrams	Other
structure of email-threads	Other
structure-sharing	Method
structure-sharing of graphs	Other
structured  dictionary	Material
structured data	Material
structured databases	Material
structured inheritance network (si-nets) paradigm	Method
structured learning methods	Method
structured light method	Method
structured methods	Generic
structured natural language data	Material
structured-light methods	Method
structured-light setup	Other
structures	Generic
structures of classes	Other
sttk	Method
studies	Generic
sub-voxel precision	Eval
subcategorization acquisition	Task
subcategorization cues	Other
subcategorization frames	Other
subcategorization frames  ( scfs )	Other
subgraphs	Other
subjective human judgments	Other
subjective intelligibility scores	Eval
subjective scores	Other
subjective visual attribute	Other
sublanguage	Other
sublanguage and domain-specific grammar	Method
submanifold	Other
submodular optimization problem	Task
subordinate clause	Other
subpixel accuracy	Eval
subpixel precision	Eval
subspace	Other
subspace constraint	Other
subspace constraints	Other
subspace-based classification	Task
subspace-segmentation methods	Method
subtitles	Material
subtle class differences	Other
subwindow search (ess) procedure	Method
success rate of retrieval	Eval
success rates	Eval
successive learners	Method
sufficient computational resources	Material
sufficient dimension reduction techniques	Method
suffix	Other
suffix analysis	Method
suffix array-based data structure	Other
sum-of-pairs	Method
summac	Material
summac-1	Material
summarization	Task
summarization  quality	Eval
summary generation	Task
summations	Generic
summit	Method
sun 4	Other
sun4	Other
super-resolution	Task
superordinate -hyponym relation	Other
superordinate substitution	Other
supervised and unsupervised methods	Method
supervised dimensionality reduction	Task
supervised discriminant subspace learning	Method
supervised image datasets	Material
supervised learning	Method
supervised machine learning	Method
supervised methods	Method
supervised ne	Task
supervised regime	Task
supervised representations	Method
supervised training data	Material
supervised, non-training intensive framework	Task
supervision	Other
supervision from semantic labels	Other
support vector machine	Method
support vector machines	Method
support vector regression	Method
suppressing noise	Task
surf	Method
surface	Other
surface isometry	Method
surface orientation	Other
surface properties	Other
surface re-flectance estimates	Method
surface realizations  of  morphological constructions	Task
surfaces	Other
surveillance scenarios	Other
surveillance videos	Material
svc	Method
svm	Method
svm classifiers	Method
svm learning	Method
svm like learning system	Method
svms	Method
switchboard dialogues	Material
symbolic and connectionist components	Method
symmetric and asym-metric instances of the traveling salesman problem (tsp)	Task
symmetric tsp	Task
synchronization overhead	Other
synchronous dependency insertion grammars	Method
synchronous dependency parser	Task
synchronous grammars	Method
synchronous tags	Method
synonym relation	Other
synonymous expressions	Other
synonymy	Other
syntactic ambiguities	Other
syntactic ambiguity resolution	Task
syntactic analyzer	Method
syntactic and pragmatic analysis	Task
syntactic and semantic dependencies	Other
syntactic behavior	Other
syntactic categories	Other
syntactic cues	Other
syntactic dependencies las	Eval
syntactic descriptions	Other
syntactic disambiguation	Task
syntactic information	Other
syntactic knowledge	Other
syntactic paraphrases	Other
syntactic parsing	Task
syntactic parsing and question answering in diagrams	Task
syntactic parsing of diagrams	Task
syntactic priming	Other
syntactic relation-based methods	Method
syntactic roles	Other
syntactic structure	Other
syntactic structure features	Other
syntactic structure information	Other
syntactically motivated relations  in  discourse	Other
syntactically shallow-parsed corpora	Material
syntactico-semantic (tectogrammatical) annotation	Other
syntax	Other
syntax  of  answer expressions	Other
syntax  of  natural languages	Other
syntax formalisms	Method
syntax proper	Other
syntax-based constraint	Other
syntax-based decoder	Method
syntax-based statistical machine translation (mt)	Task
syntax-based statistical machine translation system	Task
synthesis method	Method
synthesis of cyclopean views of extended conversational sequences	Task
synthesized speech	Material
synthesizing aging faces	Method
synthesizing complex, photo-realistic facade images	Task
synthetic and natural datasets	Material
synthetic and real data	Material
synthetic and real data examples	Material
synthetic data	Material
synthetic facial performance	Eval
synthetic scenes	Other
synthetic speech	Material
syntlex dictionary of collocations	Material
system	Generic
system combination	Method
system of relevant times	Method
system of temporal coordinates	Method
system response	Other
systematic  patterns  in  translation data	Other
systemic grammar	Method
tacitus	Method
tag	Other
tag contexts	Other
tagged text corpus	Material
taggers	Method
tagging	Task
tagging accuracy	Eval
tagging strategies	Method
tagging task	Task
tags	Method
taiwan child language corpus	Material
tap-xl automated analyst's assistant	Task
target language   word segmentation	Method
target vocabulary	Other
task	Generic
task dialogues	Material
task-based evaluation	Method
task-oriented and goal-directed dialogs	Material
task-oriented dialogs	Material
task-specific domain knowledge	Other
task-specific language development	Task
tasks	Generic
taxonomic similarity	Other
technique	Generic
techniques	Generic
technologies	Generic
technology	Generic
ted talks	Material
telephone application	Task
telephone dialogue	Other
telephone dialogues	Material
template fitting techniques	Method
template-based methods	Method
template-free approach	Method
templates	Other
temporal adverbials	Other
temporal anaphora	Task
temporal anaphora phenomena	Task
temporal anaphora resolution	Task
temporal artefacts (flicker)	Other
temporal connective	Other
temporal difference value estimation algorithms	Method
temporal evolution	Other
temporal expression anchoror (tea)	Method
temporal expressions	Other
temporal expressions  in  newswire texts	Other
temporal information	Other
temporal localiza-tion information	Other
temporal maintenance of a background model	Task
temporal order	Other
temporal perspective times	Other
temporal prior	Other
temporal series of spatial bounding boxes	Other
temporal smoothness in object shape	Other
temporally consistent representation	Method
tensor	Generic
tensor method	Method
tensor space	Other
tensor voting	Method
tensorface and eigenface representations	Method
tensors	Generic
terabyte corpus	Material
term aggregation system	Method
term error rate performance	Eval
term extraction	Task
term frequency	Other
term similarities	Other
terminal and non-terminal edges	Other
terminal substring parsing	Method
terminology structuring	Task
terrorist acts	Material
test sets	Generic
text applications	Task
text browser	Method
text classification problems	Task
text collections	Material
text data	Material
text descriptions	Material
text documents	Material
text generation	Task
text input	Material
text mining	Task
text mining method	Method
text model	Method
text processing	Task
text processing software	Task
text processors	Method
text revision	Other
text summarisation	Task
text summarization	Task
text understanding	Task
text-image editor	Method
text-level anaphora	Other
text-plan input	Other
text-to-speech conversion system	Task
text-to-speech form	Other
text-to-speech synthesis	Task
textual and prosodic  knowledge sources	Material
textual corpora	Material
textual credibility indicators	Other
textual domain	Material
textual representation	Method
texture	Other
texture and coarse scene geometry	Other
texture synthesis	Task
thai key prediction	Task
thai language	Material
thai-english language identification	Task
that	Generic
them	Generic
thematic grid tagging	Task
theme	Generic
themes	Generic
theoretical linguistic investigations	Task
theoretical physics literature	Other
theoretical predictions	Other
theory	Generic
theory of attention, intention, and aggregation of utterances	Method
theory of discourse structure	Method
theory of tenses	Other
thesaurus construction	Task
these	Generic
these techniques	Generic
thesis statements	Other
they	Generic
this	Generic
those	Generic
three techniques	Generic
three-component system	Generic
three-dimensional matching cost space	Other
three-dimensional objects	Other
three-plane graph	Method
three-way voting	Method
threshold units	Other
tight nex-ptlme complexity bounds	Other
tiling	Other
tilings	Other
timbl	Generic
time calculus for natural language (tcnl)	Other
time complexity	Eval
time consuming training stage	Other
time-complexity	Eval
time-synchronous graph-search strategy	Method
times and numerical quantities	Other
tipster applications	Task
tipster architecture	Method
tipster architecture specification	Other
tipster modules	Method
title-driven name recognition	Task
token classification task	Task
token-based models	Method
tool	Generic
tool kit	Generic
top human-ranked sentence plan	Other
top-down derivation	Other
top-level prediction task	Generic
topic detection and tracking tasks  of   event detection	Task
topic information	Other
topic signature	Other
topic signatures	Other
topical blog post retrieval	Task
topological structure	Other
topology	Generic
track clustering cost function	Method
tracker	Generic
trackers	Generic
tracking	Task
tracking framework	Method
tracking of complex non-rigid motions	Task
tracking problems	Task
tracking process	Method
traffic flow	Material
trainable components	Method
trainable sentence planner	Method
training	Task
training algorithm	Method
training and prediction costs	Other
training and test data	Material
training and testing factors	Other
training discriminative classifiers	Method
training examples	Material
training material	Material
training method	Method
training methods	Method
training resources	Material
training strategy	Method
training techniques	Method
training time	Eval
training tool	Task
trajectory basis	Other
transcription	Task
transcription errors	Other
transfer	Other
transfer approach	Method
transfer component	Method
transfer dictionary	Material
transfer learning	Method
transfer mappings	Method
transfer salient structures	Task
transfer system	Method
transferring knowledge	Task
transformation model	Method
transformation quantization	Other
transformations	Generic
translated newswire text	Material
translated ted talks	Material
translating virtual camera	Other
translation  of  anaphoric relations	Task
translation  of  english text  into  american sign language (asl) animation	Task
translation candidates	Other
translation equivalences	Other
translation errors	Other
translation invariance	Other
translation knowledge	Other
translation lexicon	Other
translation lexicon acquisition (sable)	Task
translation memory system	Method
translation paths	Other
translation probabilities	Other
translation quality	Eval
translation relation	Other
translation speed and quality	Eval
translation system	Task
translation systems	Task
translations	Other
transliteration	Task
transliteration accuracy	Eval
transliteration process	Method
transliteration/backtransliteration	Task
transparent object	Other
transparent objects	Other
traveling salesman problem	Method
traversing the data hierarchy	Method
trdr score	Eval
treatment	Generic
trec	Material
trec 2003 and trec 2004 qa tracks	Material
trec blog track test set	Material
tree	Other
tree adjoining grammar	Method
tree adjoining grammars	Method
tree structure	Other
tree-adjoining grammars (tag)	Method
tree-bank	Material
tree-based models	Method
tree-based ordering model	Method
tree-to-tree translation  of  dependency structures	Task
trees	Other
trend survey	Task
trend survey on  japanese natural language processing studies	Task
trend surveys	Task
triangularizer	Method
triangulated graph	Method
triangulation	Other
triangulation and lagc algorithms	Method
triangulation problem	Task
triangulations	Other
trifocal tensor	Method
trigger words	Other
trigram language model	Method
triphone and semiphone systems	Method
triplet sampling mechanism	Method
triplets of  words	Other
tsi-plsa	Method
tuit	Method
tumblr gif (tgif)	Material
turk-ish	Material
turkish dependency treebank	Material
turkish word structures	Material
tutorial dialogue	Material
two	Generic
two-branch neural network	Method
two-layer self-organizing neural network	Method
two-level morphology	Other
two-link arm	Other
two-pass algorithm	Generic
two-phase shift-reduce dependency parser	Method
two-point calibration	Method
two-step clustering process	Method
type of unit classifier	Other
type-unification	Method
typed feature structures	Other
typing location	Other
typing-algorithm	Method
ucf 101	Material
ucf101	Material
ultra-wide baseline matching	Task
ultra-wide baselines	Other
ultrasound sequences	Material
ultrasound sequences of the human heart	Material
un-labelled data	Material
unambiguous structures	Other
unannotated text	Material
uncalibrated 2d tracking data	Material
uncalibrated images	Material
uncertainty handling	Task
unconstrained mps grammars	Method
unconstrained videos	Material
uncontrolled images	Material
under-explored language genre of spoken language	Material
underspecified chart representations	Method
underspecified semantic representation (usr)	Method
understanding	Task
understanding natural images	Task
undisambiguated  corpus data	Material
ungrammatical input	Other
ungrammatical segmentations	Other
ungrammatical structures	Other
unification	Method
unification algorithms	Method
unification categorial grammar (ucg)	Method
unification-based grammar	Method
unification-based grammar formalism	Method
unification-based grammar parsing	Task
unification-based grammatical frameworks	Method
unification-based linguistic descriptions	Other
unification-based parsing	Task
unified active and semi-supervised regression framework	Method
unified framework	Method
unified polynomial model	Method
unified robust learning	Method
unified variational formulation	Method
uniform albedo	Other
uniform color and texture properties	Other
uniform grammar formalism	Method
uniform processing	Method
uniform sampling	Method
unifying mistake bound analysis	Method
unigram  counts	Other
uniqueness	Other
unit hilbert sphere	Other
unit l2 norm	Other
universal quantification	Other
unix and windows '95 platforms	Other
unknown illumination conditions	Other
unknown motions	Other
unknown transcriptions	Other
unknown word	Other
unknown words	Other
unl graphs	Other
unl-l0 deconverter	Method
unl-tree+l0	Other
unlabeled corpus	Material
unlabeled data	Other
unlabeled examples	Material
unlexicalized parser	Method
unlexicalized pcfg parser	Method
unmodified subgraphs	Other
unrealistic durations	Other
unrelated images	Other
unrolling hmms	Method
unseen head poses	Other
unstemmed text	Material
unstructured data sources	Material
unstructured patterns	Other
unsuper-vised induction	Method
unsupervised and supervised case	Task
unsupervised automatic acquisition  of  italian and english verb subcategorization frames (scfs)	Task
unsupervised clustering	Method
unsupervised component	Method
unsupervised discriminative clustering problem	Task
unsupervised hmm learning	Method
unsupervised learning	Method
unsupervised learning  of  parts of speech	Task
unsupervised learning  of  pos tags in english	Task
unsupervised learning algorithm	Method
unsupervised learning approach	Method
unsupervised learning method	Method
unsupervised learning of object intrinsic representation	Task
unsupervised linear regression	Method
unsupervised manner	Method
unsupervised methods	Method
unsupervised mid-level visual representation	Task
unsupervised object discovery	Task
unsupervised seg-mentation of whole objects	Task
unsupervised semi-riemannian mani-fold learning	Method
unsupervised sequential verification task	Task
unsupervised technique	Method
unsupervised training	Method
unsupervised word alignment component	Method
unsupervised wsd	Task
unsupervised wsd systems	Method
untextured objects	Other
untrimmed stream	Material
unvoiced speech	Material
urban and indoor environments	Other
us national library of medicine mesh thesaurus	Material
useful terms	Generic
user evaluation	Method
user initialization	Other
user interaction	Other
user interface styles or conventions	Other
user interfaces	Other
user knowledge modeling architecture	Method
user model	Method
user modeling component	Method
user modeling systems	Method
user models	Method
user motion pattern	Other
user proficiency	Other
user utterances	Material
user's informational goals	Other
user-directed summaries	Other
user-study	Other
usr	Method
usrs	Method
utterance	Other
utterance classification	Task
utterance features	Other
utterance verification (uv)	Method
utterances	Other
uv procedure	Method
vagueness	Other
validity of the dominant motion assumption	Other
variable con-ductance diffusion	Method
variable cutoff frequency	Other
variables	Other
variance jumps	Other
variance reduction approach svrg	Method
variant of  tags	Method
varied multiple lighting conditions	Other
vc	Method
vector components	Method
vector space model	Method
vector space model (vsm)-based text classification approach	Method
vectors representing morpho-syntactic properties	Other
velocities	Other
verb classification	Task
verb entailment	Task
verb entailment types	Other
verb final language	Material
verb forms	Other
verb semantics	Other
verb wsd problems	Task
verb-noun collocation dictionary	Material
verbal and nonverbal grounding acts	Other
verbal and nonverbal means	Method
verbal interaction	Other
verbal interactions	Other
verbal structure	Other
verbmobil task	Material
verma constraints	Other
vertebrate retina	Other
vertices	Other
vibrations	Other
video	Material
video analysis and representation	Task
video browsing and retrieval	Task
video clips	Material
video compression	Task
video footage	Other
video indexing	Task
video recognition tasks	Task
video relighting methods	Method
video representations	Generic
video segmentation	Method
video sequence	Material
"video sequence "" reillumination "" algorithm"	Method
video sequences	Material
video sequences of office scenes	Material
video streams	Material
video surveillance	Task
video surveillance systems	Task
video tubes	Material
video-based recognition of natural gestures	Task
videodisc images	Material
videos of hand-held objects	Material
videos of public squares and courtyards	Material
view dependence	Other
view generation	Task
view points	Other
view-invariant representation	Method
viewpoint	Other
viewpoint classification task	Task
viewpoints	Other
violations of individual rationality (ir)	Other
virtual camera	Other
virtual communication assistant	Other
virtual reality 3d scene modeling software	Method
vision and graphics problems	Task
vision applications	Task
vision systems	Task
visual classification	Task
visual comparisons	Other
visual content	Material
visual content captioning task	Task
visual cues	Other
visual hull proposals	Other
visual hull sampling process	Method
visual inspection	Method
visual models of 3d object categories	Task
visual object tracking	Task
visual pathway	Method
visual quality	Eval
visual representation	Method
visual speech animation	Task
visual summarization	Task
visual vocabulary	Other
visual words	Other
visualization method	Method
visually-guided arm reaching movements	Other
viterbi decoding	Method
vivid benchmark datasets	Material
vlsi	Task
vme bus	Other
vocabulary learning	Task
vocabulary tree	Other
vocabulary tree approach	Method
vocoder	Method
vocoder-based framework	Method
voice editing and indexing	Task
voice input	Material
voice interactive system	Method
voice timbre	Other
voiced parts of speech	Material
voting- and arbiter-based combination strategies	Method
vowel harmony	Other
vsm model	Method
wake-sleep recurrent attention model	Method
wall street journal treebank	Material
wallflower	Method
wallstreet journal (wsj) data	Material
warca	Method
watertight models	Method
wavelet or wavelet packets	Other
way	Generic
weak duration constraints	Other
weakly supervised algorithm	Method
weakly supervised dependency parser	Task
web	Material
web data	Material
web interfaces	Method
web search engines	Method
web visitor behavior	Other
web-based computer-assisted academic writing	Task
weight assignments	Other
weighted approximate rank component analysis (warca)	Method
weighted finite-state device	Method
weighted rank loss	Other
weighted sum	Other
weighted word error rate (wwer)	Eval
well calibrated probabilities	Other
well defined objective function	Other
well-segmented 3d skeleton data	Material
well-studied clustering techniques	Method
well-written discourse	Other
wer	Eval
wh-movement	Other
whispered voice	Material
wi systems	Method
wide coverage english grammar	Method
wide-area settings	Other
wiener filtering	Method
wireless web navigation	Task
within-view neighborhood structure preservation constraints	Other
wizard of oz technique	Method
word alignment techniques	Method
word breaking	Task
word classification	Task
word clustering	Task
word clusters	Other
word dependent substitution costs	Other
word duration constraints	Other
word duration probabilities	Other
word error rate	Eval
word error rate (wer)	Eval
word error rates	Eval
word graph	Other
word graph composition	Method
word identification	Task
word lattices	Other
word list	Other
word matches	Other
word matches and non-matches	Task
word n-gram models	Method
word or semantic error rate	Eval
word order	Other
word order generation	Task
word recognition	Task
word reordering	Other
word segmentation problem	Task
word segmentation system	Method
word sense	Other
word sense definitions	Other
word sense disambigation models	Method
word sense disambiguation (wsd)	Task
word sense disambiguation (wsd) problems	Task
word sense disambiguation (wsd) systems	Method
word sense disambiguation algorithms	Method
word senses	Other
word significance	Other
word significance (weights)	Other
word similarity	Task
word similarity measures	Eval
word sketch engine	Task
word spotting	Task
word structures	Other
word vectors	Other
word-aligned corpora	Material
word-based alignments	Method
word-based collocational properties	Other
word-based models	Method
word-based system	Method
word-based trigram language model	Method
word-dependent substitution costs	Other
word-lemma based feature function models	Method
word-lemma model	Method
word-sense ambiguity	Task
word-sense disambiguation algorithm	Method
word-sense disambiguation systems	Method
word-sense distinctions	Other
word-to-word alignments	Other
word-trie	Method
word-trigram recognition	Method
wordform model	Method
wordnet	Material
wordnet-based measures	Method
wordnets	Material
words	Generic
words formed ad-hoc	Other
words subset	Other
wordspotter	Method
world knowledge	Other
worst-case parsing time complexity	Eval
writing analysis	Task
writing intelligibility	Other
written and spoken language	Material
written english	Material
written language	Material
written texts	Material
wsd   accuracy	Eval
wsd accuracy	Eval
wsd datasets	Material
wsd evaluation methodology	Method
wsd models	Method
wsd programs	Task
wsd system	Method
wsd system based on lemmas	Method
wsd task	Task
wsi	Task
wsi algorithm	Method
wsj and bref corpora	Material
wsj-trained recognizer	Method
wwer	Eval
xml-based markup language	Other
xtag	Method
yoopick	Method
zero pronouns	Other
zero value of gaussian process	Other
zero-crossings	Other
◆ g-consistency	Other
